year,county,state,county_name,income,perc_change,est_mortgage,income_needed,actual_needed_diff,actual_needed_ratio
 2019,Abbeville,SC,"Abbeville, SC",34990,0,710,30429,4561,1.15
 2020,Abbeville,SC,"Abbeville, SC",38094,9,914,39171,-1077,0.97
 2021,Abbeville,SC,"Abbeville, SC",40596,7,1014,43457,-2861,0.93
 2019,Acadia,LA,"Acadia, LA",39740,0,682,29229,10511,1.36
 2020,Acadia,LA,"Acadia, LA",43800,10,736,31543,12257,1.39
 2021,Acadia,LA,"Acadia, LA",45805,5,813,34843,10962,1.31
 2019,Accomack,VA,"Accomack, VA",48224,0,1027,44014,4210,1.1
 2020,Accomack,VA,"Accomack, VA",51730,7,1105,47357,4373,1.09
 2021,Accomack,VA,"Accomack, VA",57520,11,1417,60729,-3209,0.95
 2019,Ada,ID,"Ada, ID",54866,0,1848,79200,-24334,0.69
 2020,Ada,ID,"Ada, ID",58976,8,1998,85629,-26653,0.69
 2021,Ada,ID,"Ada, ID",62610,6,2769,118671,-56061,0.53
 2019,Adair,IA,"Adair, IA",49947,0,648,27771,22176,1.8
 2020,Adair,IA,"Adair, IA",54324,9,656,28114,26210,1.93
 2021,Adair,IA,"Adair, IA",61765,14,716,30686,31079,2.01
 2019,Adair,KY,"Adair, KY",33442,0,624,26743,6699,1.25
 2020,Adair,KY,"Adair, KY",37409,12,750,32143,5266,1.16
 2021,Adair,KY,"Adair, KY",41385,11,1181,50614,-9229,0.82
 2019,Adair,MO,"Adair, MO",33223,0,497,21300,11923,1.56
 2020,Adair,MO,"Adair, MO",35904,8,444,19029,16875,1.89
 2021,Adair,MO,"Adair, MO",37898,6,634,27171,10727,1.39
 2019,Adair,OK,"Adair, OK",32854,0,544,23314,9540,1.41
 2020,Adair,OK,"Adair, OK",36005,10,552,23657,12348,1.52
 2021,Adair,OK,"Adair, OK",41496,15,839,35957,5539,1.15
 2019,Adams,CO,"Adams, CO",45266,0,2023,86700,-41434,0.52
 2020,Adams,CO,"Adams, CO",48606,7,2143,91843,-43237,0.53
 2021,Adams,CO,"Adams, CO",53183,9,2589,110957,-57774,0.48
 2019,Adams,IA,"Adams, IA",56104,0,732,31371,24733,1.79
 2020,Adams,IA,"Adams, IA",53550,-5,355,15214,38336,3.52
 2021,Adams,IA,"Adams, IA",62223,16,349,14957,47266,4.16
 2019,Adams,ID,"Adams, ID",40107,0,1797,77014,-36907,0.52
 2020,Adams,ID,"Adams, ID",42496,6,2087,89443,-46947,0.48
 2021,Adams,ID,"Adams, ID",44261,4,4808,206057,-161796,0.21
 2019,Adams,IL,"Adams, IL",47040,0,619,26529,20511,1.77
 2020,Adams,IL,"Adams, IL",51072,9,678,29057,22015,1.76
 2021,Adams,IL,"Adams, IL",55254,8,668,28629,26625,1.93
 2019,Adams,IN,"Adams, IN",40009,0,554,23743,16266,1.69
 2020,Adams,IN,"Adams, IN",42799,7,585,25071,17728,1.71
 2021,Adams,IN,"Adams, IN",47209,10,818,35057,12152,1.35
 2019,Adams,MS,"Adams, MS",36413,0,944,40457,-4044,0.9
 2020,Adams,MS,"Adams, MS",39621,9,892,38229,1392,1.04
 2021,Adams,MS,"Adams, MS",42911,8,911,39043,3868,1.1
 2019,Adams,ND,"Adams, ND",48914,0,775,33214,15700,1.47
 2020,Adams,ND,"Adams, ND",57099,17,628,26914,30185,2.12
 2021,Adams,ND,"Adams, ND",57586,1,640,27429,30157,2.1
 2019,Adams,NE,"Adams, NE",50436,0,873,37414,13022,1.35
 2020,Adams,NE,"Adams, NE",53834,7,976,41829,12005,1.29
 2021,Adams,NE,"Adams, NE",58072,8,785,33643,24429,1.73
 2019,Adams,OH,"Adams, OH",35806,0,455,19500,16306,1.84
 2020,Adams,OH,"Adams, OH",40100,12,611,26186,13914,1.53
 2021,Adams,OH,"Adams, OH",43092,8,676,28971,14121,1.49
 2019,Adams,PA,"Adams, PA",49380,0,1104,47314,2066,1.04
 2020,Adams,PA,"Adams, PA",52801,7,1282,54943,-2142,0.96
 2021,Adams,PA,"Adams, PA",55752,6,1526,65400,-9648,0.85
 2019,Adams,WA,"Adams, WA",40526,0,787,33729,6797,1.2
 2020,Adams,WA,"Adams, WA",45040,11,932,39943,5097,1.13
 2021,Adams,WA,"Adams, WA",47867,6,1438,61629,-13762,0.78
 2019,Adams,WI,"Adams, WI",41638,0,887,38014,3624,1.1
 2020,Adams,WI,"Adams, WI",44057,6,935,40071,3986,1.1
 2021,Adams,WI,"Adams, WI",46002,4,1013,43414,2588,1.06
 2019,Addison,VT,"Addison, VT",53670,0,1532,65657,-11987,0.82
 2020,Addison,VT,"Addison, VT",57156,7,1420,60857,-3701,0.94
 2021,Addison,VT,"Addison, VT",59540,4,1714,73457,-13917,0.81
 2019,Aiken,SC,"Aiken, SC",45459,0,1116,47829,-2370,0.95
 2020,Aiken,SC,"Aiken, SC",48208,6,1172,50229,-2021,0.96
 2021,Aiken,SC,"Aiken, SC",51057,6,1365,58500,-7443,0.87
 2019,Aitkin,MN,"Aitkin, MN",42044,0,979,41957,87,1
 2020,Aitkin,MN,"Aitkin, MN",46856,11,955,40929,5927,1.14
 2021,Aitkin,MN,"Aitkin, MN",49255,5,1375,58929,-9674,0.84
 2019,Alachua,FL,"Alachua, FL",45870,0,1222,52371,-6501,0.88
 2020,Alachua,FL,"Alachua, FL",48858,7,1350,57857,-8999,0.84
 2021,Alachua,FL,"Alachua, FL",52367,7,1393,59700,-7333,0.88
 2019,Alamance,NC,"Alamance, NC",41493,0,1156,49543,-8050,0.84
 2020,Alamance,NC,"Alamance, NC",44418,7,1185,50786,-6368,0.87
 2021,Alamance,NC,"Alamance, NC",48118,8,1432,61371,-13253,0.78
 2019,Alameda,CA,"Alameda, CA",80623,0,3858,165343,-84720,0.49
 2020,Alameda,CA,"Alameda, CA",88841,10,3964,169886,-81045,0.52
 2021,Alameda,CA,"Alameda, CA",99746,12,3950,169286,-69540,0.59
 2019,Alamosa,CO,"Alamosa, CO",38025,0,1037,44443,-6418,0.86
 2020,Alamosa,CO,"Alamosa, CO",41152,8,1188,50914,-9762,0.81
 2021,Alamosa,CO,"Alamosa, CO",44507,8,1350,57857,-13350,0.77
 2019,Albany,NY,"Albany, NY",62495,0,1443,61843,652,1.01
 2020,Albany,NY,"Albany, NY",67115,7,1325,56786,10329,1.18
 2021,Albany,NY,"Albany, NY",70947,6,1348,57771,13176,1.23
 2019,Albany,WY,"Albany, WY",42955,0,1345,57643,-14688,0.75
 2020,Albany,WY,"Albany, WY",46056,7,1436,61543,-15487,0.75
 2021,Albany,WY,"Albany, WY",48528,5,1919,82243,-33715,0.59
 2019,Alcona,MI,"Alcona, MI",41782,0,611,26186,15596,1.6
 2020,Alcona,MI,"Alcona, MI",46504,11,692,29657,16847,1.57
 2021,Alcona,MI,"Alcona, MI",49262,6,806,34543,14719,1.43
 2019,Alcorn,MS,"Alcorn, MS",38576,0,755,32357,6219,1.19
 2020,Alcorn,MS,"Alcorn, MS",41396,7,790,33857,7539,1.22
 2021,Alcorn,MS,"Alcorn, MS",44255,7,941,40329,3926,1.1
 2019,Aleutians East,AK,"Aleutians East, AK",60712,0,1318,56486,4226,1.07
 2020,Aleutians East,AK,"Aleutians East, AK",57605,-5,1102,47229,10376,1.22
 2021,Aleutians East,AK,"Aleutians East, AK",60174,5,1175,50357,9817,1.19
 2019,Aleutians West,AK,"Aleutians West, AK",60610,0,799,34243,26367,1.77
 2020,Aleutians West,AK,"Aleutians West, AK",63509,5,767,32871,30638,1.93
 2019,Alfalfa,OK,"Alfalfa, OK",38514,0,311,13329,25185,2.89
 2020,Alfalfa,OK,"Alfalfa, OK",40128,4,450,19286,20842,2.08
 2021,Alfalfa,OK,"Alfalfa, OK",43695,9,424,18171,25524,2.4
 2019,Alger,MI,"Alger, MI",35126,0,778,33343,1783,1.05
 2020,Alger,MI,"Alger, MI",39479,12,721,30900,8579,1.28
 2021,Alger,MI,"Alger, MI",42171,7,698,29914,12257,1.41
 2019,Allamakee,IA,"Allamakee, IA",47182,0,678,29057,18125,1.62
 2020,Allamakee,IA,"Allamakee, IA",49538,5,638,27343,22195,1.81
 2021,Allamakee,IA,"Allamakee, IA",53807,9,1011,43329,10478,1.24
 2019,Allegan,MI,"Allegan, MI",46130,0,1498,64200,-18070,0.72
 2020,Allegan,MI,"Allegan, MI",50402,9,1526,65400,-14998,0.77
 2021,Allegan,MI,"Allegan, MI",53375,6,1923,82414,-29039,0.65
 2019,Allegany,MD,"Allegany, MD",41720,0,520,22286,19434,1.87
 2020,Allegany,MD,"Allegany, MD",45070,8,491,21043,24027,2.14
 2021,Allegany,MD,"Allegany, MD",47347,5,553,23700,23647,2
 2019,Allegany,NY,"Allegany, NY",36813,0,414,17743,19070,2.07
 2020,Allegany,NY,"Allegany, NY",40558,10,403,17271,23287,2.35
 2021,Allegany,NY,"Allegany, NY",42569,5,601,25757,16812,1.65
 2019,Alleghany,NC,"Alleghany, NC",40046,0,486,20829,19217,1.92
 2020,Alleghany,NC,"Alleghany, NC",42648,7,1141,48900,-6252,0.87
 2021,Alleghany,NC,"Alleghany, NC",45206,6,1854,79457,-34251,0.57
 2019,Allegheny,PA,"Allegheny, PA",63478,0,950,40714,22764,1.56
 2020,Allegheny,PA,"Allegheny, PA",66702,5,1114,47743,18959,1.4
 2021,Allegheny,PA,"Allegheny, PA",70580,6,1114,47743,22837,1.48
 2019,Allen,IN,"Allen, IN",47398,0,988,42343,5055,1.12
 2020,Allen,IN,"Allen, IN",50640,7,1129,48386,2254,1.05
 2021,Allen,IN,"Allen, IN",54681,8,1119,47957,6724,1.14
 2019,Allen,KS,"Allen, KS",42470,0,377,16157,26313,2.63
 2020,Allen,KS,"Allen, KS",45635,8,381,16329,29306,2.79
 2021,Allen,KS,"Allen, KS",49326,8,717,30729,18597,1.61
 2019,Allen,KY,"Allen, KY",34703,0,771,33043,1660,1.05
 2020,Allen,KY,"Allen, KY",37077,7,1016,43543,-6466,0.85
 2021,Allen,KY,"Allen, KY",40682,10,1024,43886,-3204,0.93
 2019,Allen,LA,"Allen, LA",38723,0,707,30300,8423,1.28
 2020,Allen,LA,"Allen, LA",41335,7,555,23786,17549,1.74
 2021,Allen,LA,"Allen, LA",42949,4,490,21000,21949,2.05
 2019,Allen,OH,"Allen, OH",43618,0,616,26400,17218,1.65
 2020,Allen,OH,"Allen, OH",47314,9,613,26271,21043,1.8
 2021,Allen,OH,"Allen, OH",50353,6,427,18300,32053,2.75
 2019,Allendale,SC,"Allendale, SC",34309,0,533,22843,11466,1.5
 2020,Allendale,SC,"Allendale, SC",39852,16,613,26271,13581,1.52
 2021,Allendale,SC,"Allendale, SC",41814,5,517,22157,19657,1.89
 2019,Alpena,MI,"Alpena, MI",40817,0,573,24557,16260,1.66
 2020,Alpena,MI,"Alpena, MI",45497,12,618,26486,19011,1.72
 2021,Alpena,MI,"Alpena, MI",48428,6,671,28757,19671,1.68
 2019,Alpine,CA,"Alpine, CA",80225,0,1969,84386,-4161,0.95
 2020,Alpine,CA,"Alpine, CA",75220,-6,1851,79329,-4109,0.95
 2021,Alpine,CA,"Alpine, CA",72734,-3,1146,49114,23620,1.48
 2019,Amador,CA,"Amador, CA",44121,0,1867,80014,-35893,0.55
 2020,Amador,CA,"Amador, CA",47790,8,2009,86100,-38310,0.56
 2021,Amador,CA,"Amador, CA",49752,4,2337,100157,-50405,0.5
 2019,Amelia,VA,"Amelia, VA",43703,0,1435,61500,-17797,0.71
 2020,Amelia,VA,"Amelia, VA",46379,6,1461,62614,-16235,0.74
 2021,Amelia,VA,"Amelia, VA",50973,10,1613,69129,-18156,0.74
 2019,Amherst,VA,"Amherst, VA",38200,0,462,19800,18400,1.93
 2020,Amherst,VA,"Amherst, VA",41218,8,929,39814,1404,1.04
 2021,Amherst,VA,"Amherst, VA",44051,7,1237,53014,-8963,0.83
 2019,Amite,MS,"Amite, MS",33523,0,677,29014,4509,1.16
 2020,Amite,MS,"Amite, MS",35618,6,554,23743,11875,1.5
 2021,Amite,MS,"Amite, MS",39407,11,1762,75514,-36107,0.52
 2019,Anchorage,AK,"Anchorage, AK",67317,0,1551,66471,846,1.01
 2020,Anchorage,AK,"Anchorage, AK",68815,2,1611,69043,-228,1
 2021,Anchorage,AK,"Anchorage, AK",72032,5,1682,72086,-54,1
 2019,Anderson,KS,"Anderson, KS",39916,0,441,18900,21016,2.11
 2020,Anderson,KS,"Anderson, KS",45567,14,556,23829,21738,1.91
 2021,Anderson,KS,"Anderson, KS",52810,16,548,23486,29324,2.25
 2019,Anderson,KY,"Anderson, KY",39315,0,862,36943,2372,1.06
 2020,Anderson,KY,"Anderson, KY",42309,8,998,42771,-462,0.99
 2021,Anderson,KY,"Anderson, KY",45331,7,1112,47657,-2326,0.95
 2019,Anderson,SC,"Anderson, SC",41621,0,1050,45000,-3379,0.92
 2020,Anderson,SC,"Anderson, SC",43933,6,1106,47400,-3467,0.93
 2021,Anderson,SC,"Anderson, SC",46894,7,1358,58200,-11306,0.81
 2019,Anderson,TN,"Anderson, TN",44090,0,1095,46929,-2839,0.94
 2020,Anderson,TN,"Anderson, TN",47198,7,1055,45214,1984,1.04
 2021,Anderson,TN,"Anderson, TN",50901,8,1331,57043,-6142,0.89
 2019,Anderson,TX,"Anderson, TX",36532,0,806,34543,1989,1.06
 2020,Anderson,TX,"Anderson, TX",38898,7,750,32143,6755,1.21
 2021,Anderson,TX,"Anderson, TX",42444,9,958,41057,1387,1.03
 2019,Andrew,MO,"Andrew, MO",44650,0,1051,45043,-393,0.99
 2020,Andrew,MO,"Andrew, MO",47612,7,1081,46329,1283,1.03
 2021,Andrew,MO,"Andrew, MO",50693,7,915,39214,11479,1.29
 2019,Andrews,TX,"Andrews, TX",53300,0,1118,47914,5386,1.11
 2020,Andrews,TX,"Andrews, TX",49329,-8,1101,47186,2143,1.05
 2021,Andrews,TX,"Andrews, TX",52943,7,1231,52757,186,1
 2019,Androscoggin,ME,"Androscoggin, ME",42075,0,915,39214,2861,1.07
 2020,Androscoggin,ME,"Androscoggin, ME",46144,10,1134,48600,-2456,0.95
 2021,Androscoggin,ME,"Androscoggin, ME",49766,8,1291,55329,-5563,0.9
 2019,Angelina,TX,"Angelina, TX",40417,0,889,38100,2317,1.06
 2020,Angelina,TX,"Angelina, TX",42691,6,1007,43157,-466,0.99
 2021,Angelina,TX,"Angelina, TX",46170,8,1281,54900,-8730,0.84
 2019,Anne Arundel,MD,"Anne Arundel, MD",68225,0,2057,88157,-19932,0.77
 2020,Anne Arundel,MD,"Anne Arundel, MD",72003,6,2203,94414,-22411,0.76
 2021,Anne Arundel,MD,"Anne Arundel, MD",76059,6,2150,92143,-16084,0.83
 2019,Anoka,MN,"Anoka, MN",52820,0,1758,75343,-22523,0.7
 2020,Anoka,MN,"Anoka, MN",56014,6,1670,71571,-15557,0.78
 2021,Anoka,MN,"Anoka, MN",59397,6,1741,74614,-15217,0.8
 2019,Anson,NC,"Anson, NC",40616,0,585,25071,15545,1.62
 2020,Anson,NC,"Anson, NC",42055,4,378,16200,25855,2.6
 2021,Anson,NC,"Anson, NC",47744,14,688,29486,18258,1.62
 2019,Antelope,NE,"Antelope, NE",57774,0,345,14786,42988,3.91
 2020,Antelope,NE,"Antelope, NE",71488,24,607,26014,45474,2.75
 2021,Antelope,NE,"Antelope, NE",74129,4,733,31414,42715,2.36
 2019,Antrim,MI,"Antrim, MI",49163,0,1114,47743,1420,1.03
 2020,Antrim,MI,"Antrim, MI",53579,9,1300,55714,-2135,0.96
 2021,Antrim,MI,"Antrim, MI",55759,4,1659,71100,-15341,0.78
 2019,Apache,AZ,"Apache, AZ",36803,0,1181,50614,-13811,0.73
 2020,Apache,AZ,"Apache, AZ",42196,15,1367,58586,-16390,0.72
 2021,Apache,AZ,"Apache, AZ",45671,8,1943,83271,-37600,0.55
 2019,Appanoose,IA,"Appanoose, IA",39600,0,428,18343,21257,2.16
 2020,Appanoose,IA,"Appanoose, IA",43053,9,490,21000,22053,2.05
 2021,Appanoose,IA,"Appanoose, IA",46396,8,610,26143,20253,1.77
 2019,Appling,GA,"Appling, GA",35398,0,758,32486,2912,1.09
 2020,Appling,GA,"Appling, GA",38878,10,846,36257,2621,1.07
 2021,Appling,GA,"Appling, GA",41863,8,1055,45214,-3351,0.93
 2019,Appomattox,VA,"Appomattox, VA",39235,0,489,20957,18278,1.87
 2020,Appomattox,VA,"Appomattox, VA",41944,7,904,38743,3201,1.08
 2021,Appomattox,VA,"Appomattox, VA",44943,7,1166,49971,-5028,0.9
 2019,Aransas,TX,"Aransas, TX",55184,0,1329,56957,-1773,0.97
 2020,Aransas,TX,"Aransas, TX",56433,2,1443,61843,-5410,0.91
 2021,Aransas,TX,"Aransas, TX",59878,6,1974,84600,-24722,0.71
 2019,Arapahoe,CO,"Arapahoe, CO",65322,0,2155,92357,-27035,0.71
 2020,Arapahoe,CO,"Arapahoe, CO",68630,5,2313,99129,-30499,0.69
 2021,Arapahoe,CO,"Arapahoe, CO",74267,8,2562,109800,-35533,0.68
 2019,Archer,TX,"Archer, TX",54894,0,1165,49929,4965,1.1
 2020,Archer,TX,"Archer, TX",57669,5,721,30900,26769,1.87
 2021,Archer,TX,"Archer, TX",60101,4,1555,66643,-6542,0.9
 2019,Archuleta,CO,"Archuleta, CO",46973,0,2464,105600,-58627,0.44
 2020,Archuleta,CO,"Archuleta, CO",50527,8,2365,101357,-50830,0.5
 2021,Archuleta,CO,"Archuleta, CO",52312,4,4094,175457,-123145,0.3
 2019,Arenac,MI,"Arenac, MI",39779,0,540,23143,16636,1.72
 2020,Arenac,MI,"Arenac, MI",44841,13,620,26571,18270,1.69
 2021,Arenac,MI,"Arenac, MI",47470,6,845,36214,11256,1.31
 2019,Arkansas,AR,"Arkansas, AR",46906,0,542,23229,23677,2.02
 2020,Arkansas,AR,"Arkansas, AR",52609,12,607,26014,26595,2.02
 2021,Arkansas,AR,"Arkansas, AR",56733,8,300,12857,43876,4.41
 2019,Arlington,VA,"Arlington, VA",97629,0,4076,174686,-77057,0.56
 2020,Arlington,VA,"Arlington, VA",100687,3,4516,193543,-92856,0.52
 2021,Arlington,VA,"Arlington, VA",107603,7,2525,108214,-611,0.99
 2019,Armstrong,PA,"Armstrong, PA",46020,0,433,18557,27463,2.48
 2020,Armstrong,PA,"Armstrong, PA",50598,10,590,25286,25312,2
 2021,Armstrong,PA,"Armstrong, PA",54198,7,543,23271,30927,2.33
 2019,Armstrong,TX,"Armstrong, TX",55506,0,461,19757,35749,2.81
 2020,Armstrong,TX,"Armstrong, TX",58244,5,535,22929,35315,2.54
 2021,Armstrong,TX,"Armstrong, TX",61382,5,1113,47700,13682,1.29
 2019,Aroostook,ME,"Aroostook, ME",42725,0,519,22243,20482,1.92
 2020,Aroostook,ME,"Aroostook, ME",47070,10,517,22157,24913,2.12
 2021,Aroostook,ME,"Aroostook, ME",49883,6,789,33814,16069,1.48
 2019,Ascension,LA,"Ascension, LA",52409,0,1308,56057,-3648,0.93
 2020,Ascension,LA,"Ascension, LA",55067,5,1314,56314,-1247,0.98
 2021,Ascension,LA,"Ascension, LA",58566,6,1736,74400,-15834,0.79
 2019,Ashe,NC,"Ashe, NC",38065,0,434,18600,19465,2.05
 2020,Ashe,NC,"Ashe, NC",41284,9,1535,65786,-24502,0.63
 2021,Ashe,NC,"Ashe, NC",44203,7,2000,85714,-41511,0.52
 2019,Ashley,AR,"Ashley, AR",38172,0,505,21643,16529,1.76
 2020,Ashley,AR,"Ashley, AR",40395,6,585,25071,15324,1.61
 2021,Ashley,AR,"Ashley, AR",42844,6,448,19200,23644,2.23
 2019,Ashtabula,OH,"Ashtabula, OH",39535,0,588,25200,14335,1.57
 2020,Ashtabula,OH,"Ashtabula, OH",43074,9,655,28071,15003,1.53
 2021,Ashtabula,OH,"Ashtabula, OH",46280,7,711,30471,15809,1.52
 2019,Asotin,WA,"Asotin, WA",48040,0,1270,54429,-6389,0.88
 2020,Asotin,WA,"Asotin, WA",51453,7,1238,53057,-1604,0.97
 2021,Asotin,WA,"Asotin, WA",55564,8,1791,76757,-21193,0.72
 2019,Assumption,LA,"Assumption, LA",50156,0,951,40757,9399,1.23
 2020,Assumption,LA,"Assumption, LA",52452,5,925,39643,12809,1.32
 2021,Assumption,LA,"Assumption, LA",56352,7,1218,52200,4152,1.08
 2019,Atascosa,TX,"Atascosa, TX",40588,0,1094,46886,-6298,0.87
 2020,Atascosa,TX,"Atascosa, TX",43238,7,1122,48086,-4848,0.9
 2021,Atascosa,TX,"Atascosa, TX",46737,8,1215,52071,-5334,0.9
 2019,Atchison,KS,"Atchison, KS",38631,0,365,15643,22988,2.47
 2020,Atchison,KS,"Atchison, KS",42396,10,373,15986,26410,2.65
 2021,Atchison,KS,"Atchison, KS",44710,6,514,22029,22681,2.03
 2019,Atchison,MO,"Atchison, MO",44786,0,415,17786,27000,2.52
 2020,Atchison,MO,"Atchison, MO",49644,11,372,15943,33701,3.11
 2021,Atchison,MO,"Atchison, MO",54179,9,650,27857,26322,1.94
 2019,Athens,OH,"Athens, OH",35910,0,882,37800,-1890,0.95
 2020,Athens,OH,"Athens, OH",38491,7,827,35443,3048,1.09
 2021,Athens,OH,"Athens, OH",40663,6,842,36086,4577,1.13
 2019,Atkinson,GA,"Atkinson, GA",30314,0,1890,81000,-50686,0.37
 2020,Atkinson,GA,"Atkinson, GA",32402,7,1523,65271,-32869,0.5
 2021,Atkinson,GA,"Atkinson, GA",35527,10,1256,53829,-18302,0.66
 2019,Atlantic,NJ,"Atlantic, NJ",50196,0,1185,50786,-590,0.99
 2020,Atlantic,NJ,"Atlantic, NJ",55273,10,1193,51129,4144,1.08
 2021,Atlantic,NJ,"Atlantic, NJ",58310,6,1403,60129,-1819,0.97
 2019,Atoka,OK,"Atoka, OK",32373,0,1003,42986,-10613,0.75
 2020,Atoka,OK,"Atoka, OK",34326,6,763,32700,1626,1.05
 2021,Atoka,OK,"Atoka, OK",36195,5,1279,54814,-18619,0.66
 2019,Attala,MS,"Attala, MS",35013,0,497,21300,13713,1.64
 2020,Attala,MS,"Attala, MS",39450,13,500,21429,18021,1.84
 2021,Attala,MS,"Attala, MS",42044,7,525,22500,19544,1.87
 2019,Audrain,MO,"Audrain, MO",37613,0,441,18900,18713,1.99
 2020,Audrain,MO,"Audrain, MO",41328,10,421,18043,23285,2.29
 2021,Audrain,MO,"Audrain, MO",44319,7,497,21300,23019,2.08
 2019,Audubon,IA,"Audubon, IA",50982,0,382,16371,34611,3.11
 2020,Audubon,IA,"Audubon, IA",53279,5,427,18300,34979,2.91
 2021,Audubon,IA,"Audubon, IA",62773,18,703,30129,32644,2.08
 2019,Auglaize,OH,"Auglaize, OH",47864,0,770,33000,14864,1.45
 2020,Auglaize,OH,"Auglaize, OH",51426,7,765,32786,18640,1.57
 2021,Auglaize,OH,"Auglaize, OH",54964,7,775,33214,21750,1.65
 2019,Aurora,SD,"Aurora, SD",40181,0,744,31886,8295,1.26
 2020,Aurora,SD,"Aurora, SD",48166,20,602,25800,22366,1.87
 2021,Aurora,SD,"Aurora, SD",54512,13,740,31714,22798,1.72
 2019,Austin,TX,"Austin, TX",53854,0,1279,54814,-960,0.98
 2020,Austin,TX,"Austin, TX",55151,2,1272,54514,637,1.01
 2021,Austin,TX,"Austin, TX",58284,6,1856,79543,-21259,0.73
 2019,Autauga,AL,"Autauga, AL",42846,0,983,42129,717,1.02
 2020,Autauga,AL,"Autauga, AL",45248,6,1105,47357,-2109,0.96
 2021,Autauga,AL,"Autauga, AL",48347,7,1401,60043,-11696,0.81
 2019,Avery,NC,"Avery, NC",37300,0,891,38186,-886,0.98
 2020,Avery,NC,"Avery, NC",40197,8,2100,90000,-49803,0.45
 2021,Avery,NC,"Avery, NC",43022,7,2917,125014,-81992,0.34
 2019,Avoyelles,LA,"Avoyelles, LA",38845,0,583,24986,13859,1.55
 2020,Avoyelles,LA,"Avoyelles, LA",42588,10,466,19971,22617,2.13
 2021,Avoyelles,LA,"Avoyelles, LA",45777,8,690,29571,16206,1.55
 2019,Baca,CO,"Baca, CO",39990,0,406,17400,22590,2.3
 2020,Baca,CO,"Baca, CO",46142,15,368,15771,30371,2.93
 2021,Baca,CO,"Baca, CO",52905,15,576,24686,28219,2.14
 2019,Bacon,GA,"Bacon, GA",32699,0,731,31329,1370,1.04
 2020,Bacon,GA,"Bacon, GA",37802,16,639,27386,10416,1.38
 2021,Bacon,GA,"Bacon, GA",39471,4,2030,87000,-47529,0.45
 2019,Bailey,TX,"Bailey, TX",44309,0,557,23871,20438,1.86
 2020,Bailey,TX,"Bailey, TX",49655,12,850,36429,13226,1.36
 2021,Bailey,TX,"Bailey, TX",51709,4,863,36986,14723,1.4
 2019,Baker,FL,"Baker, FL",35058,0,1131,48471,-13413,0.72
 2020,Baker,FL,"Baker, FL",37403,7,1122,48086,-10683,0.78
 2021,Baker,FL,"Baker, FL",40735,9,1437,61586,-20851,0.66
 2019,Baker,GA,"Baker, GA",41675,0,730,31286,10389,1.33
 2020,Baker,GA,"Baker, GA",45195,8,416,17829,27366,2.53
 2021,Baker,GA,"Baker, GA",51216,13,576,24686,26530,2.07
 2019,Baker,OR,"Baker, OR",41127,0,1075,46071,-4944,0.89
 2020,Baker,OR,"Baker, OR",44857,9,1059,45386,-529,0.99
 2021,Baker,OR,"Baker, OR",48107,7,1677,71871,-23764,0.67
 2019,Baldwin,AL,"Baldwin, AL",48380,0,1572,67371,-18991,0.72
 2020,Baldwin,AL,"Baldwin, AL",51348,6,1664,71314,-19966,0.72
 2021,Baldwin,AL,"Baldwin, AL",54659,6,2053,87986,-33327,0.62
 2019,Baldwin,GA,"Baldwin, GA",34954,0,941,40329,-5375,0.87
 2020,Baldwin,GA,"Baldwin, GA",37833,8,1098,47057,-9224,0.8
 2021,Baldwin,GA,"Baldwin, GA",40542,7,863,36986,3556,1.1
 2019,Ballard,KY,"Ballard, KY",41576,0,463,19843,21733,2.1
 2020,Ballard,KY,"Ballard, KY",45690,10,317,13586,32104,3.36
 2021,Ballard,KY,"Ballard, KY",50888,11,335,14357,36531,3.54
 2019,Baltimore City,MD,"Baltimore City, MD",50073,0,792,33943,16130,1.48
 2020,Baltimore City,MD,"Baltimore City, MD",54153,8,807,34586,19567,1.57
 2021,Baltimore City,MD,"Baltimore City, MD",58556,8,945,40500,18056,1.45
 2019,Baltimore,MD,"Baltimore, MD",61459,0,1354,58029,3430,1.06
 2020,Baltimore,MD,"Baltimore, MD",65502,7,1447,62014,3488,1.06
 2021,Baltimore,MD,"Baltimore, MD",69561,6,1563,66986,2575,1.04
 2019,Bamberg,SC,"Bamberg, SC",36074,0,558,23914,12160,1.51
 2020,Bamberg,SC,"Bamberg, SC",38795,8,445,19071,19724,2.03
 2021,Bamberg,SC,"Bamberg, SC",41081,6,880,37714,3367,1.09
 2019,Banks,GA,"Banks, GA",38328,0,1201,51471,-13143,0.74
 2020,Banks,GA,"Banks, GA",40087,5,1369,58671,-18584,0.68
 2021,Banks,GA,"Banks, GA",43766,9,1839,78814,-35048,0.56
 2019,Banner,NE,"Banner, NE",58969,0,414,17743,41226,3.32
 2020,Banner,NE,"Banner, NE",61329,4,1895,81214,-19885,0.76
 2021,Banner,NE,"Banner, NE",68909,12,52954,2269457,-2200548,0.03
 2019,Bannock,ID,"Bannock, ID",39307,0,1070,45857,-6550,0.86
 2020,Bannock,ID,"Bannock, ID",42596,8,1296,55543,-12947,0.77
 2021,Bannock,ID,"Bannock, ID",45443,7,1789,76671,-31228,0.59
 2019,Baraga,MI,"Baraga, MI",34669,0,590,25286,9383,1.37
 2020,Baraga,MI,"Baraga, MI",39616,14,731,31329,8287,1.26
 2021,Baraga,MI,"Baraga, MI",41772,5,627,26871,14901,1.55
 2019,Barber,KS,"Barber, KS",44905,0,628,26914,17991,1.67
 2020,Barber,KS,"Barber, KS",51763,15,739,31671,20092,1.63
 2021,Barber,KS,"Barber, KS",56193,9,309,13243,42950,4.24
 2019,Barbour,AL,"Barbour, AL",34870,0,889,38100,-3230,0.92
 2020,Barbour,AL,"Barbour, AL",37120,7,894,38314,-1194,0.97
 2021,Barbour,AL,"Barbour, AL",40428,9,1253,53700,-13272,0.75
 2019,Barbour,WV,"Barbour, WV",35788,0,569,24386,11402,1.47
 2020,Barbour,WV,"Barbour, WV",38258,7,536,22971,15287,1.67
 2021,Barbour,WV,"Barbour, WV",40576,6,414,17743,22833,2.29
 2019,Barnes,ND,"Barnes, ND",55652,0,747,32014,23638,1.74
 2020,Barnes,ND,"Barnes, ND",63045,13,884,37886,25159,1.66
 2021,Barnes,ND,"Barnes, ND",66463,5,867,37157,29306,1.79
 2019,Barnstable,MA,"Barnstable, MA",74107,0,2804,120171,-46064,0.62
 2020,Barnstable,MA,"Barnstable, MA",79136,7,2848,122057,-42921,0.65
 2021,Barnstable,MA,"Barnstable, MA",83191,5,3752,160800,-77609,0.52
 2019,Barnwell,SC,"Barnwell, SC",35568,0,598,25629,9939,1.39
 2020,Barnwell,SC,"Barnwell, SC",38813,9,425,18214,20599,2.13
 2021,Barnwell,SC,"Barnwell, SC",41828,8,1010,43286,-1458,0.97
 2019,Barren,KY,"Barren, KY",37317,0,697,29871,7446,1.25
 2020,Barren,KY,"Barren, KY",40241,8,789,33814,6427,1.19
 2021,Barren,KY,"Barren, KY",43678,9,919,39386,4292,1.11
 2019,Barron,WI,"Barron, WI",50289,0,950,40714,9575,1.24
 2020,Barron,WI,"Barron, WI",53375,6,1009,43243,10132,1.23
 2021,Barron,WI,"Barron, WI",56898,7,1220,52286,4612,1.09
 2019,Barrow,GA,"Barrow, GA",38623,0,1168,50057,-11434,0.77
 2020,Barrow,GA,"Barrow, GA",41378,7,1203,51557,-10179,0.8
 2021,Barrow,GA,"Barrow, GA",44534,8,1343,57557,-13023,0.77
 2019,Barry,MI,"Barry, MI",46199,0,1089,46671,-472,0.99
 2020,Barry,MI,"Barry, MI",49975,8,1115,47786,2189,1.05
 2021,Barry,MI,"Barry, MI",52951,6,1270,54429,-1478,0.97
 2019,Barry,MO,"Barry, MO",36511,0,870,37286,-775,0.98
 2020,Barry,MO,"Barry, MO",38718,6,870,37286,1432,1.04
 2021,Barry,MO,"Barry, MO",41248,7,1050,45000,-3752,0.92
 2019,Bartholomew,IN,"Bartholomew, IN",54102,0,1325,56786,-2684,0.95
 2020,Bartholomew,IN,"Bartholomew, IN",57535,6,1209,51814,5721,1.11
 2021,Bartholomew,IN,"Bartholomew, IN",61136,6,1426,61114,22,1
 2019,Barton,KS,"Barton, KS",49043,0,531,22757,26286,2.16
 2020,Barton,KS,"Barton, KS",51237,5,532,22800,28437,2.25
 2021,Barton,KS,"Barton, KS",53532,5,521,22329,31203,2.4
 2019,Barton,MO,"Barton, MO",35273,0,456,19543,15730,1.8
 2020,Barton,MO,"Barton, MO",40842,16,421,18043,22799,2.26
 2021,Barton,MO,"Barton, MO",42329,4,576,24686,17643,1.71
 2019,Bartow,GA,"Bartow, GA",40386,0,1124,48171,-7785,0.84
 2020,Bartow,GA,"Bartow, GA",43775,8,1164,49886,-6111,0.88
 2021,Bartow,GA,"Bartow, GA",47162,8,1514,64886,-17724,0.73
 2019,Bastrop,TX,"Bastrop, TX",37749,0,1368,58629,-20880,0.64
 2020,Bastrop,TX,"Bastrop, TX",39956,6,1465,62786,-22830,0.64
 2021,Bastrop,TX,"Bastrop, TX",44230,11,2188,93771,-49541,0.47
 2019,Bates,MO,"Bates, MO",40670,0,693,29700,10970,1.37
 2020,Bates,MO,"Bates, MO",44537,10,839,35957,8580,1.24
 2021,Bates,MO,"Bates, MO",46821,5,822,35229,11592,1.33
 2019,Bath,KY,"Bath, KY",30954,0,758,32486,-1532,0.95
 2020,Bath,KY,"Bath, KY",34299,11,824,35314,-1015,0.97
 2021,Bath,KY,"Bath, KY",37710,10,1219,52243,-14533,0.72
 2019,Bath,VA,"Bath, VA",64918,0,2123,90986,-26068,0.71
 2020,Bath,VA,"Bath, VA",68508,6,1779,76243,-7735,0.9
 2021,Bath,VA,"Bath, VA",72157,5,2058,88200,-16043,0.82
 2019,Baxter,AR,"Baxter, AR",38535,0,925,39643,-1108,0.97
 2020,Baxter,AR,"Baxter, AR",40968,6,975,41786,-818,0.98
 2021,Baxter,AR,"Baxter, AR",43479,6,1163,49843,-6364,0.87
 2019,Bay,FL,"Bay, FL",46452,0,1508,64629,-18177,0.72
 2020,Bay,FL,"Bay, FL",50394,9,1407,60300,-9906,0.84
 2021,Bay,FL,"Bay, FL",53980,7,1888,80914,-26934,0.67
 2019,Bay,MI,"Bay, MI",43230,0,445,19071,24159,2.27
 2020,Bay,MI,"Bay, MI",47430,10,434,18600,28830,2.55
 2021,Bay,MI,"Bay, MI",50396,6,559,23957,26439,2.1
 2019,Bayfield,WI,"Bayfield, WI",48197,0,1092,46800,1397,1.03
 2020,Bayfield,WI,"Bayfield, WI",50826,6,1214,52029,-1203,0.98
 2021,Bayfield,WI,"Bayfield, WI",53902,6,1815,77786,-23884,0.69
 2019,Baylor,TX,"Baylor, TX",48504,0,370,15857,32647,3.06
 2020,Baylor,TX,"Baylor, TX",54941,13,432,18514,36427,2.97
 2021,Baylor,TX,"Baylor, TX",58779,7,718,30771,28008,1.91
 2019,Beadle,SD,"Beadle, SD",48558,0,757,32443,16115,1.5
 2020,Beadle,SD,"Beadle, SD",52156,7,743,31843,20313,1.64
 2021,Beadle,SD,"Beadle, SD",55409,6,811,34757,20652,1.59
 2019,Bear Lake,ID,"Bear Lake, ID",40547,0,1420,60857,-20310,0.67
 2020,Bear Lake,ID,"Bear Lake, ID",43776,8,1844,79029,-35253,0.55
 2021,Bear Lake,ID,"Bear Lake, ID",45385,4,3433,147129,-101744,0.31
 2019,Beaufort,NC,"Beaufort, NC",46467,0,1207,51729,-5262,0.9
 2020,Beaufort,NC,"Beaufort, NC",49748,7,1246,53400,-3652,0.93
 2021,Beaufort,NC,"Beaufort, NC",54165,9,1342,57514,-3349,0.94
 2019,Beaufort,SC,"Beaufort, SC",63489,0,2106,90257,-26768,0.7
 2020,Beaufort,SC,"Beaufort, SC",66301,4,2138,91629,-25328,0.72
 2021,Beaufort,SC,"Beaufort, SC",70166,6,2583,110700,-40534,0.63
 2019,Beauregard,LA,"Beauregard, LA",44208,0,899,38529,5679,1.15
 2020,Beauregard,LA,"Beauregard, LA",47500,7,966,41400,6100,1.15
 2021,Beauregard,LA,"Beauregard, LA",50015,5,800,34286,15729,1.46
 2019,Beaver,OK,"Beaver, OK",55602,0,423,18129,37473,3.07
 2020,Beaver,OK,"Beaver, OK",56870,2,354,15171,41699,3.75
 2021,Beaver,OK,"Beaver, OK",65668,16,484,20743,44925,3.17
 2019,Beaver,PA,"Beaver, PA",49021,0,730,31286,17735,1.57
 2020,Beaver,PA,"Beaver, PA",53495,9,848,36343,17152,1.47
 2021,Beaver,PA,"Beaver, PA",56452,6,893,38271,18181,1.48
 2019,Beaver,UT,"Beaver, UT",36202,0,838,35914,288,1.01
 2020,Beaver,UT,"Beaver, UT",43658,21,843,36129,7529,1.21
 2021,Beaver,UT,"Beaver, UT",46960,8,1667,71443,-24483,0.66
 2019,Beaverhead,MT,"Beaverhead, MT",48960,0,1342,57514,-8554,0.85
 2020,Beaverhead,MT,"Beaverhead, MT",53114,9,1396,59829,-6715,0.89
 2021,Beaverhead,MT,"Beaverhead, MT",54430,3,1353,57986,-3556,0.94
 2019,Becker,MN,"Becker, MN",48118,0,1402,60086,-11968,0.8
 2020,Becker,MN,"Becker, MN",51710,8,1436,61543,-9833,0.84
 2021,Becker,MN,"Becker, MN",56147,9,1718,73629,-17482,0.76
 2019,Beckham,OK,"Beckham, OK",37090,0,693,29700,7390,1.25
 2020,Beckham,OK,"Beckham, OK",37821,2,704,30171,7650,1.25
 2021,Beckham,OK,"Beckham, OK",40147,6,767,32871,7276,1.22
 2019,Bedford,PA,"Bedford, PA",42995,0,678,29057,13938,1.48
 2020,Bedford,PA,"Bedford, PA",46031,7,725,31071,14960,1.48
 2021,Bedford,PA,"Bedford, PA",49916,8,754,32314,17602,1.54
 2019,Bedford,TN,"Bedford, TN",39243,0,1256,53829,-14586,0.73
 2020,Bedford,TN,"Bedford, TN",41608,6,1237,53014,-11406,0.78
 2021,Bedford,TN,"Bedford, TN",46083,11,1860,79714,-33631,0.58
 2019,Bedford,VA,"Bedford, VA",48174,0,927,39729,8445,1.21
 2020,Bedford,VA,"Bedford, VA",51062,6,1510,64714,-13652,0.79
 2021,Bedford,VA,"Bedford, VA",53861,6,1886,80829,-26968,0.67
 2019,Bee,TX,"Bee, TX",31593,0,728,31200,393,1.01
 2020,Bee,TX,"Bee, TX",32880,4,640,27429,5451,1.2
 2021,Bee,TX,"Bee, TX",34738,6,953,40843,-6105,0.85
 2019,Belknap,NH,"Belknap, NH",64287,0,1442,61800,2487,1.04
 2020,Belknap,NH,"Belknap, NH",67965,6,1467,62871,5094,1.08
 2021,Belknap,NH,"Belknap, NH",71958,6,2065,88500,-16542,0.81
 2019,Bell,KY,"Bell, KY",32028,0,435,18643,13385,1.72
 2020,Bell,KY,"Bell, KY",37095,16,599,25671,11424,1.45
 2021,Bell,KY,"Bell, KY",41763,13,529,22671,19092,1.84
 2019,Bell,TX,"Bell, TX",43781,0,1067,45729,-1948,0.96
 2020,Bell,TX,"Bell, TX",46459,6,1099,47100,-641,0.99
 2021,Bell,TX,"Bell, TX",49405,6,1331,57043,-7638,0.87
 2019,Belmont,OH,"Belmont, OH",41870,0,636,27257,14613,1.54
 2020,Belmont,OH,"Belmont, OH",42535,2,478,20486,22049,2.08
 2021,Belmont,OH,"Belmont, OH",45375,7,741,31757,13618,1.43
 2019,Beltrami,MN,"Beltrami, MN",43165,0,956,40971,2194,1.05
 2020,Beltrami,MN,"Beltrami, MN",47241,9,1088,46629,612,1.01
 2021,Beltrami,MN,"Beltrami, MN",50833,8,1283,54986,-4153,0.92
 2019,Ben Hill,GA,"Ben Hill, GA",31711,0,536,22971,8740,1.38
 2020,Ben Hill,GA,"Ben Hill, GA",35427,12,447,19157,16270,1.85
 2021,Ben Hill,GA,"Ben Hill, GA",38640,9,863,36986,1654,1.04
 2019,Benewah,ID,"Benewah, ID",38912,0,935,40071,-1159,0.97
 2020,Benewah,ID,"Benewah, ID",42238,9,1215,52071,-9833,0.81
 2021,Benewah,ID,"Benewah, ID",43922,4,3303,141557,-97635,0.31
 2019,Bennett,SD,"Bennett, SD",36061,0,1015,43500,-7439,0.83
 2021,Bennett,SD,"Bennett, SD",46894,11,3832,164229,-117335,0.29
 2019,Bennington,VT,"Bennington, VT",54828,0,1646,70543,-15715,0.78
 2020,Bennington,VT,"Bennington, VT",58349,6,1650,70714,-12365,0.83
 2021,Bennington,VT,"Bennington, VT",61287,5,2141,91757,-30470,0.67
 2019,Benson,ND,"Benson, ND",39623,0,544,23314,16309,1.7
 2020,Benson,ND,"Benson, ND",49406,25,1102,47229,2177,1.05
 2021,Benson,ND,"Benson, ND",55282,12,1175,50357,4925,1.1
 2019,Bent,CO,"Bent, CO",27231,0,508,21771,5460,1.25
 2020,Bent,CO,"Bent, CO",29796,9,513,21986,7810,1.36
 2021,Bent,CO,"Bent, CO",32716,10,693,29700,3016,1.1
 2019,Benton,AR,"Benton, AR",86848,0,1409,60386,26462,1.44
 2020,Benton,AR,"Benton, AR",86938,0,1447,62014,24924,1.4
 2021,Benton,AR,"Benton, AR",91687,6,1783,76414,15273,1.2
 2019,Benton,IA,"Benton, IA",54238,0,762,32657,21581,1.66
 2020,Benton,IA,"Benton, IA",57560,6,668,28629,28931,2.01
 2021,Benton,IA,"Benton, IA",63072,10,666,28543,34529,2.21
 2019,Benton,IN,"Benton, IN",41626,0,440,18857,22769,2.21
 2020,Benton,IN,"Benton, IN",47708,15,321,13757,33951,3.47
 2021,Benton,IN,"Benton, IN",53602,12,686,29400,24202,1.82
 2019,Benton,MN,"Benton, MN",45691,0,1130,48429,-2738,0.94
 2020,Benton,MN,"Benton, MN",49675,9,1181,50614,-939,0.98
 2021,Benton,MN,"Benton, MN",53214,7,1441,61757,-8543,0.86
 2019,Benton,MO,"Benton, MO",38951,0,766,32829,6122,1.19
 2020,Benton,MO,"Benton, MO",40715,5,735,31500,9215,1.29
 2021,Benton,MO,"Benton, MO",43097,6,965,41357,1740,1.04
 2019,Benton,MS,"Benton, MS",34858,0,480,20571,14287,1.69
 2020,Benton,MS,"Benton, MS",37877,9,785,33643,4234,1.13
 2021,Benton,MS,"Benton, MS",41767,10,660,28286,13481,1.48
 2019,Benton,OR,"Benton, OR",47290,0,2316,99257,-51967,0.48
 2020,Benton,OR,"Benton, OR",50628,7,2120,90857,-40229,0.56
 2021,Benton,OR,"Benton, OR",54174,7,2527,108300,-54126,0.5
 2019,Benton,TN,"Benton, TN",35071,0,831,35614,-543,0.98
 2020,Benton,TN,"Benton, TN",38021,8,955,40929,-2908,0.93
 2021,Benton,TN,"Benton, TN",40963,8,980,42000,-1037,0.98
 2019,Benton,WA,"Benton, WA",48522,0,1623,69557,-21035,0.7
 2020,Benton,WA,"Benton, WA",51895,7,1906,81686,-29791,0.64
 2021,Benton,WA,"Benton, WA",54958,6,2563,109843,-54885,0.5
 2019,Benzie,MI,"Benzie, MI",47113,0,1323,56700,-9587,0.83
 2020,Benzie,MI,"Benzie, MI",52273,11,1250,53571,-1298,0.98
 2021,Benzie,MI,"Benzie, MI",54684,5,1698,72771,-18087,0.75
 2019,Bergen,NJ,"Bergen, NJ",87903,0,2773,118843,-30940,0.74
 2020,Bergen,NJ,"Bergen, NJ",90759,3,3042,130371,-39612,0.7
 2021,Bergen,NJ,"Bergen, NJ",97343,7,2874,123171,-25828,0.79
 2019,Berkeley,SC,"Berkeley, SC",43510,0,1394,59743,-16233,0.73
 2020,Berkeley,SC,"Berkeley, SC",45454,5,1438,61629,-16175,0.74
 2021,Berkeley,SC,"Berkeley, SC",48919,8,1844,79029,-30110,0.62
 2019,Berkeley,WV,"Berkeley, WV",44030,0,1100,47143,-3113,0.93
 2020,Berkeley,WV,"Berkeley, WV",46686,6,1144,49029,-2343,0.95
 2021,Berkeley,WV,"Berkeley, WV",49759,7,1435,61500,-11741,0.81
 2019,Berks,PA,"Berks, PA",50657,0,973,41700,8957,1.21
 2020,Berks,PA,"Berks, PA",55045,9,1179,50529,4516,1.09
 2021,Berks,PA,"Berks, PA",57970,5,1153,49414,8556,1.17
 2019,Berkshire,MA,"Berkshire, MA",56861,0,1769,75814,-18953,0.75
 2020,Berkshire,MA,"Berkshire, MA",61586,8,1885,80786,-19200,0.76
 2021,Berkshire,MA,"Berkshire, MA",65050,6,2336,100114,-35064,0.65
 2019,Bernalillo,NM,"Bernalillo, NM",46130,0,1204,51600,-5470,0.89
 2020,Bernalillo,NM,"Bernalillo, NM",49817,8,1341,57471,-7654,0.87
 2021,Bernalillo,NM,"Bernalillo, NM",53616,8,1621,69471,-15855,0.77
 2019,Berrien,GA,"Berrien, GA",34454,0,635,27214,7240,1.27
 2020,Berrien,GA,"Berrien, GA",37305,8,689,29529,7776,1.26
 2021,Berrien,GA,"Berrien, GA",39945,7,714,30600,9345,1.31
 2019,Berrien,MI,"Berrien, MI",49735,0,1502,64371,-14636,0.77
 2020,Berrien,MI,"Berrien, MI",54303,9,1466,62829,-8526,0.86
 2021,Berrien,MI,"Berrien, MI",59656,10,1606,68829,-9173,0.87
 2019,Bertie,NC,"Bertie, NC",39224,0,441,18900,20324,2.08
 2020,Bertie,NC,"Bertie, NC",42000,7,404,17314,24686,2.43
 2021,Bertie,NC,"Bertie, NC",48377,15,644,27600,20777,1.75
 2019,Bethel,AK,"Bethel, AK",44649,0,1575,67500,-22851,0.66
 2020,Bethel,AK,"Bethel, AK",46299,4,1407,60300,-14001,0.77
 2021,Bethel,AK,"Bethel, AK",48189,4,2218,95057,-46868,0.51
 2019,Bexar,TX,"Bexar, TX",47081,0,1295,55500,-8419,0.85
 2020,Bexar,TX,"Bexar, TX",48348,3,1261,54043,-5695,0.89
 2021,Bexar,TX,"Bexar, TX",51780,7,1450,62143,-10363,0.83
 2019,Bibb,AL,"Bibb, AL",31800,0,757,32443,-643,0.98
 2020,Bibb,AL,"Bibb, AL",34598,9,815,34929,-331,0.99
 2021,Bibb,AL,"Bibb, AL",36892,7,637,27300,9592,1.35
 2019,Bibb,GA,"Bibb, GA",40356,0,640,27429,12927,1.47
 2020,Bibb,GA,"Bibb, GA",43592,8,675,28929,14663,1.51
 2021,Bibb,GA,"Bibb, GA",46781,7,725,31071,15710,1.51
 2019,Bienville,LA,"Bienville, LA",39088,0,391,16757,22331,2.33
 2020,Bienville,LA,"Bienville, LA",42743,9,465,19929,22814,2.14
 2021,Bienville,LA,"Bienville, LA",46442,9,471,20186,26256,2.3
 2019,Big Horn,MT,"Big Horn, MT",31525,0,851,36471,-4946,0.86
 2020,Big Horn,MT,"Big Horn, MT",35760,13,767,32871,2889,1.09
 2021,Big Horn,MT,"Big Horn, MT",36517,2,1037,44443,-7926,0.82
 2019,Big Horn,WY,"Big Horn, WY",40898,0,820,35143,5755,1.16
 2020,Big Horn,WY,"Big Horn, WY",45433,11,919,39386,6047,1.15
 2021,Big Horn,WY,"Big Horn, WY",47259,4,1422,60943,-13684,0.78
 2019,Big Stone,MN,"Big Stone, MN",49836,0,363,15557,34279,3.2
 2020,Big Stone,MN,"Big Stone, MN",58966,18,531,22757,36209,2.59
 2021,Big Stone,MN,"Big Stone, MN",64816,10,1110,47571,17245,1.36
 2019,Billings,ND,"Billings, ND",79623,0,1862,79800,-177,1
 2020,Billings,ND,"Billings, ND",83228,5,3100,132857,-49629,0.63
 2021,Billings,ND,"Billings, ND",92571,11,1423,60986,31585,1.52
 2019,Bingham,ID,"Bingham, ID",37355,0,1047,44871,-7516,0.83
 2020,Bingham,ID,"Bingham, ID",41008,10,1453,62271,-21263,0.66
 2021,Bingham,ID,"Bingham, ID",42774,4,1922,82371,-39597,0.52
 2019,Black Hawk,IA,"Black Hawk, IA",45649,0,733,31414,14235,1.45
 2020,Black Hawk,IA,"Black Hawk, IA",48983,7,766,32829,16154,1.49
 2021,Black Hawk,IA,"Black Hawk, IA",51911,6,677,29014,22897,1.79
 2019,Blackford,IN,"Blackford, IN",37571,0,258,11057,26514,3.4
 2020,Blackford,IN,"Blackford, IN",40164,7,250,10714,29450,3.75
 2021,Blackford,IN,"Blackford, IN",44325,10,711,30471,13854,1.45
 2019,Bladen,NC,"Bladen, NC",39138,0,870,37286,1852,1.05
 2020,Bladen,NC,"Bladen, NC",43369,11,944,40457,2912,1.07
 2021,Bladen,NC,"Bladen, NC",47567,10,1193,51129,-3562,0.93
 2019,Blaine,ID,"Blaine, ID",122878,0,4722,202371,-79493,0.61
 2020,Blaine,ID,"Blaine, ID",127990,4,6632,284229,-156239,0.45
 2021,Blaine,ID,"Blaine, ID",134722,5,7231,309900,-175178,0.43
 2019,Blaine,MT,"Blaine, MT",28752,0,614,26314,2438,1.09
 2020,Blaine,MT,"Blaine, MT",32137,12,664,28457,3680,1.13
 2021,Blaine,MT,"Blaine, MT",34095,6,873,37414,-3319,0.91
 2019,Blaine,NE,"Blaine, NE",58725,0,0,0,58725,0
 2020,Blaine,NE,"Blaine, NE",66390,13,779,33386,33004,1.99
 2021,Blaine,NE,"Blaine, NE",62594,-6,9593,411129,-348535,0.15
 2019,Blaine,OK,"Blaine, OK",47191,0,367,15729,31462,3
 2020,Blaine,OK,"Blaine, OK",45732,-3,559,23957,21775,1.91
 2021,Blaine,OK,"Blaine, OK",53081,16,552,23657,29424,2.24
 2019,Blair,PA,"Blair, PA",47034,0,608,26057,20977,1.81
 2020,Blair,PA,"Blair, PA",51007,8,599,25671,25336,1.99
 2021,Blair,PA,"Blair, PA",54470,7,705,30214,24256,1.8
 2019,Blanco,TX,"Blanco, TX",60511,0,2201,94329,-33818,0.64
 2020,Blanco,TX,"Blanco, TX",63932,6,1903,81557,-17625,0.78
 2021,Blanco,TX,"Blanco, TX",66088,3,2951,126471,-60383,0.52
 2019,Bleckley,GA,"Bleckley, GA",35755,0,635,27214,8541,1.31
 2020,Bleckley,GA,"Bleckley, GA",38355,7,651,27900,10455,1.37
 2021,Bleckley,GA,"Bleckley, GA",41298,8,703,30129,11169,1.37
 2019,Bledsoe,TN,"Bledsoe, TN",28598,0,848,36343,-7745,0.79
 2020,Bledsoe,TN,"Bledsoe, TN",30830,8,816,34971,-4141,0.88
 2021,Bledsoe,TN,"Bledsoe, TN",33675,9,1315,56357,-22682,0.6
 2019,Blount,AL,"Blount, AL",36542,0,908,38914,-2372,0.94
 2020,Blount,AL,"Blount, AL",38351,5,866,37114,1237,1.03
 2021,Blount,AL,"Blount, AL",42634,11,1164,49886,-7252,0.85
 2019,Blount,TN,"Blount, TN",45860,0,1372,58800,-12940,0.78
 2020,Blount,TN,"Blount, TN",49002,7,1506,64543,-15541,0.76
 2021,Blount,TN,"Blount, TN",52596,7,1918,82200,-29604,0.64
 2019,Blue Earth,MN,"Blue Earth, MN",45468,0,1206,51686,-6218,0.88
 2020,Blue Earth,MN,"Blue Earth, MN",49109,8,1266,54257,-5148,0.91
 2021,Blue Earth,MN,"Blue Earth, MN",51834,6,1301,55757,-3923,0.93
 2019,Boise,ID,"Boise, ID",47045,0,1601,68614,-21569,0.69
 2020,Boise,ID,"Boise, ID",50581,8,1711,73329,-22748,0.69
 2021,Boise,ID,"Boise, ID",53198,5,3510,150429,-97231,0.35
 2019,Bolivar,MS,"Bolivar, MS",37303,0,648,27771,9532,1.34
 2020,Bolivar,MS,"Bolivar, MS",41211,11,678,29057,12154,1.42
 2021,Bolivar,MS,"Bolivar, MS",46512,13,740,31714,14798,1.47
 2019,Bollinger,MO,"Bollinger, MO",38100,0,561,24043,14057,1.58
 2020,Bollinger,MO,"Bollinger, MO",41916,10,544,23314,18602,1.8
 2021,Bollinger,MO,"Bollinger, MO",44552,6,1038,44486,66,1
 2019,Bon Homme,SD,"Bon Homme, SD",40638,0,583,24986,15652,1.63
 2020,Bon Homme,SD,"Bon Homme, SD",42965,6,491,21043,21922,2.04
 2021,Bon Homme,SD,"Bon Homme, SD",47665,11,490,21000,26665,2.27
 2019,Bond,IL,"Bond, IL",37518,0,384,16457,21061,2.28
 2020,Bond,IL,"Bond, IL",40863,9,539,23100,17763,1.77
 2021,Bond,IL,"Bond, IL",44653,9,528,22629,22024,1.97
 2019,Bonner,ID,"Bonner, ID",44003,0,2066,88543,-44540,0.5
 2020,Bonner,ID,"Bonner, ID",47782,9,2581,110614,-62832,0.43
 2021,Bonner,ID,"Bonner, ID",49868,4,3587,153729,-103861,0.32
 2019,Bonneville,ID,"Bonneville, ID",50865,0,1355,58071,-7206,0.88
 2020,Bonneville,ID,"Bonneville, ID",55037,8,1422,60943,-5906,0.9
 2021,Bonneville,ID,"Bonneville, ID",58430,6,2184,93600,-35170,0.62
 2019,Boone,AR,"Boone, AR",36495,0,678,29057,7438,1.26
 2020,Boone,AR,"Boone, AR",38988,7,841,36043,2945,1.08
 2021,Boone,AR,"Boone, AR",42642,9,1111,47614,-4972,0.9
 2019,Boone,IA,"Boone, IA",48103,0,666,28543,19560,1.69
 2020,Boone,IA,"Boone, IA",51104,6,740,31714,19390,1.61
 2021,Boone,IA,"Boone, IA",54521,7,869,37243,17278,1.46
 2019,Boone,IL,"Boone, IL",47814,0,1106,47400,414,1.01
 2020,Boone,IL,"Boone, IL",50785,6,1063,45557,5228,1.11
 2021,Boone,IL,"Boone, IL",54496,7,1338,57343,-2847,0.95
 2019,Boone,IN,"Boone, IN",77754,0,2108,90343,-12589,0.86
 2020,Boone,IN,"Boone, IN",80234,3,1996,85543,-5309,0.94
 2021,Boone,IN,"Boone, IN",84985,6,2058,88200,-3215,0.96
 2019,Boone,KY,"Boone, KY",50245,0,1335,57214,-6969,0.88
 2020,Boone,KY,"Boone, KY",53445,6,1548,66343,-12898,0.81
 2021,Boone,KY,"Boone, KY",56759,6,1878,80486,-23727,0.71
 2019,Boone,MO,"Boone, MO",49251,0,1149,49243,8,1
 2020,Boone,MO,"Boone, MO",51723,5,1199,51386,337,1.01
 2021,Boone,MO,"Boone, MO",54522,5,1346,57686,-3164,0.95
 2019,Boone,NE,"Boone, NE",56680,0,962,41229,15451,1.37
 2020,Boone,NE,"Boone, NE",66670,18,723,30986,35684,2.15
 2021,Boone,NE,"Boone, NE",74085,11,755,32357,41728,2.29
 2019,Boone,WV,"Boone, WV",35464,0,657,28157,7307,1.26
 2020,Boone,WV,"Boone, WV",38831,10,633,27129,11702,1.43
 2021,Boone,WV,"Boone, WV",41910,8,673,28843,13067,1.45
 2020,Borden,TX,"Borden, TX",71300,-8,1103,47271,24029,1.51
 2021,Borden,TX,"Borden, TX",101470,42,1103,47271,54199,2.15
 2019,Bosque,TX,"Bosque, TX",44165,0,721,30900,13265,1.43
 2020,Bosque,TX,"Bosque, TX",46807,6,978,41914,4893,1.12
 2021,Bosque,TX,"Bosque, TX",50943,9,1275,54643,-3700,0.93
 2019,Bossier,LA,"Bossier, LA",45177,0,1187,50871,-5694,0.89
 2020,Bossier,LA,"Bossier, LA",48685,8,1107,47443,1242,1.03
 2021,Bossier,LA,"Bossier, LA",51970,7,1073,45986,5984,1.13
 2019,Botetourt,VA,"Botetourt, VA",51755,0,1268,54343,-2588,0.95
 2020,Botetourt,VA,"Botetourt, VA",54534,5,1498,64200,-9666,0.85
 2021,Botetourt,VA,"Botetourt, VA",57997,6,1700,72857,-14860,0.8
 2019,Bottineau,ND,"Bottineau, ND",60713,0,884,37886,22827,1.6
 2020,Bottineau,ND,"Bottineau, ND",68775,13,719,30814,37961,2.23
 2021,Bottineau,ND,"Bottineau, ND",69935,2,1208,51771,18164,1.35
 2019,Boulder,CO,"Boulder, CO",79698,0,3076,131829,-52131,0.6
 2020,Boulder,CO,"Boulder, CO",83173,4,3296,141257,-58084,0.59
 2021,Boulder,CO,"Boulder, CO",89593,8,3858,165343,-75750,0.54
 2019,Boundary,ID,"Boundary, ID",38708,0,1644,70457,-31749,0.55
 2020,Boundary,ID,"Boundary, ID",41509,7,1900,81429,-39920,0.51
 2021,Boundary,ID,"Boundary, ID",44200,7,2900,124286,-80086,0.36
 2019,Bourbon,KS,"Bourbon, KS",41958,0,397,17014,24944,2.47
 2020,Bourbon,KS,"Bourbon, KS",45653,9,405,17357,28296,2.63
 2021,Bourbon,KS,"Bourbon, KS",47885,5,423,18129,29756,2.64
 2019,Bourbon,KY,"Bourbon, KY",49887,0,1140,48857,1030,1.02
 2020,Bourbon,KY,"Bourbon, KY",51145,3,1511,64757,-13612,0.79
 2021,Bourbon,KY,"Bourbon, KY",55087,8,1614,69171,-14084,0.8
 2019,Bowie,TX,"Bowie, TX",41563,0,773,33129,8434,1.25
 2020,Bowie,TX,"Bowie, TX",44597,7,803,34414,10183,1.3
 2021,Bowie,TX,"Bowie, TX",47792,7,910,39000,8792,1.23
 2019,Bowman,ND,"Bowman, ND",68487,0,777,33300,35187,2.06
 2020,Bowman,ND,"Bowman, ND",69660,2,723,30986,38674,2.25
 2021,Bowman,ND,"Bowman, ND",77069,11,685,29357,47712,2.63
 2019,Box Butte,NE,"Box Butte, NE",48835,0,637,27300,21535,1.79
 2020,Box Butte,NE,"Box Butte, NE",50917,4,471,20186,30731,2.52
 2021,Box Butte,NE,"Box Butte, NE",55642,9,543,23271,32371,2.39
 2019,Box Elder,UT,"Box Elder, UT",38927,0,1480,63429,-24502,0.61
 2020,Box Elder,UT,"Box Elder, UT",42295,9,1510,64714,-22419,0.65
 2021,Box Elder,UT,"Box Elder, UT",45456,8,2226,95400,-49944,0.48
 2019,Boyd,KY,"Boyd, KY",39064,0,566,24257,14807,1.61
 2020,Boyd,KY,"Boyd, KY",42757,10,580,24857,17900,1.72
 2021,Boyd,KY,"Boyd, KY",46039,8,667,28586,17453,1.61
 2019,Boyd,NE,"Boyd, NE",58251,0,124,5314,52937,10.96
 2020,Boyd,NE,"Boyd, NE",65645,13,486,20829,44816,3.15
 2021,Boyd,NE,"Boyd, NE",74685,14,584,25029,49656,2.98
 2019,Boyle,KY,"Boyle, KY",39831,0,936,40114,-283,0.99
 2020,Boyle,KY,"Boyle, KY",43226,9,1073,45986,-2760,0.94
 2021,Boyle,KY,"Boyle, KY",46181,7,1073,45986,195,1
 2019,Bracken,KY,"Bracken, KY",37799,0,461,19757,18042,1.91
 2020,Bracken,KY,"Bracken, KY",41421,10,656,28114,13307,1.47
 2021,Bracken,KY,"Bracken, KY",44913,8,748,32057,12856,1.4
 2019,Bradford,FL,"Bradford, FL",34515,0,1032,44229,-9714,0.78
 2020,Bradford,FL,"Bradford, FL",36956,7,827,35443,1513,1.04
 2021,Bradford,FL,"Bradford, FL",39748,8,1246,53400,-13652,0.74
 2019,Bradford,PA,"Bradford, PA",43589,0,728,31200,12389,1.4
 2020,Bradford,PA,"Bradford, PA",46144,6,869,37243,8901,1.24
 2021,Bradford,PA,"Bradford, PA",49063,6,913,39129,9934,1.25
 2019,Bradley,AR,"Bradley, AR",39690,0,402,17229,22461,2.3
 2020,Bradley,AR,"Bradley, AR",42740,8,426,18257,24483,2.34
 2021,Bradley,AR,"Bradley, AR",46734,9,325,13929,32805,3.36
 2019,Bradley,TN,"Bradley, TN",40228,0,1130,48429,-8201,0.83
 2020,Bradley,TN,"Bradley, TN",43319,8,1171,50186,-6867,0.86
 2021,Bradley,TN,"Bradley, TN",46409,7,1578,67629,-21220,0.69
 2019,Branch,MI,"Branch, MI",37279,0,682,29229,8050,1.28
 2020,Branch,MI,"Branch, MI",41384,11,685,29357,12027,1.41
 2021,Branch,MI,"Branch, MI",45325,10,906,38829,6496,1.17
 2019,Brantley,GA,"Brantley, GA",29129,0,689,29529,-400,0.99
 2020,Brantley,GA,"Brantley, GA",32549,12,774,33171,-622,0.98
 2021,Brantley,GA,"Brantley, GA",35435,9,1011,43329,-7894,0.82
 2019,Braxton,WV,"Braxton, WV",36234,0,415,17786,18448,2.04
 2020,Braxton,WV,"Braxton, WV",39143,8,466,19971,19172,1.96
 2021,Braxton,WV,"Braxton, WV",41547,6,550,23571,17976,1.76
 2019,Brazoria,TX,"Brazoria, TX",51117,0,1363,58414,-7297,0.88
 2020,Brazoria,TX,"Brazoria, TX",53365,4,1321,56614,-3249,0.94
 2021,Brazoria,TX,"Brazoria, TX",56360,6,1660,71143,-14783,0.79
 2019,Brazos,TX,"Brazos, TX",41404,0,1265,54214,-12810,0.76
 2020,Brazos,TX,"Brazos, TX",43484,5,1285,55071,-11587,0.79
 2021,Brazos,TX,"Brazos, TX",46702,7,1459,62529,-15827,0.75
 2019,Breathitt,KY,"Breathitt, KY",31692,0,827,35443,-3751,0.89
 2020,Breathitt,KY,"Breathitt, KY",35222,11,640,27429,7793,1.28
 2021,Breathitt,KY,"Breathitt, KY",39754,13,965,41357,-1603,0.96
 2019,Breckinridge,KY,"Breckinridge, KY",35521,0,712,30514,5007,1.16
 2020,Breckinridge,KY,"Breckinridge, KY",39121,10,890,38143,978,1.03
 2021,Breckinridge,KY,"Breckinridge, KY",42724,9,860,36857,5867,1.16
 2019,Bremer,IA,"Bremer, IA",50742,0,709,30386,20356,1.67
 2020,Bremer,IA,"Bremer, IA",54062,7,856,36686,17376,1.47
 2021,Bremer,IA,"Bremer, IA",57876,7,916,39257,18619,1.47
 2019,Brevard,FL,"Brevard, FL",48725,0,1355,58071,-9346,0.84
 2020,Brevard,FL,"Brevard, FL",51769,6,1423,60986,-9217,0.85
 2021,Brevard,FL,"Brevard, FL",55477,7,1766,75686,-20209,0.73
 2019,Brewster,TX,"Brewster, TX",46357,0,1178,50486,-4129,0.92
 2020,Brewster,TX,"Brewster, TX",48670,5,1367,58586,-9916,0.83
 2021,Brewster,TX,"Brewster, TX",53014,9,1852,79371,-26357,0.67
 2019,Briscoe,TX,"Briscoe, TX",45182,0,279,11957,33225,3.78
 2020,Briscoe,TX,"Briscoe, TX",45515,1,349,14957,30558,3.04
 2021,Briscoe,TX,"Briscoe, TX",58862,29,520,22286,36576,2.64
 2019,Bristol Bay,AK,"Bristol Bay, AK",136337,0,540,23143,113194,5.89
 2020,Bristol Bay,AK,"Bristol Bay, AK",138387,2,648,27771,110616,4.98
 2021,Bristol Bay,AK,"Bristol Bay, AK",155155,12,1847,79157,75998,1.96
 2019,Bristol,MA,"Bristol, MA",55047,0,1772,75943,-20896,0.72
 2020,Bristol,MA,"Bristol, MA",61116,11,1922,82371,-21255,0.74
 2021,Bristol,MA,"Bristol, MA",64924,6,2166,92829,-27905,0.7
 2019,Bristol,RI,"Bristol, RI",78427,0,2615,112071,-33644,0.7
 2020,Bristol,RI,"Bristol, RI",82053,5,2737,117300,-35247,0.7
 2021,Bristol,RI,"Bristol, RI",87810,7,2517,107871,-20061,0.81
 2019,Broadwater,MT,"Broadwater, MT",43874,0,1600,68571,-24697,0.64
 2020,Broadwater,MT,"Broadwater, MT",46978,7,1610,69000,-22022,0.68
 2021,Broadwater,MT,"Broadwater, MT",47541,1,2939,125957,-78416,0.38
 2019,Bronx,NY,"Bronx, NY",37090,0,2017,86443,-49353,0.43
 2020,Bronx,NY,"Bronx, NY",42414,14,2092,89657,-47243,0.47
 2021,Bronx,NY,"Bronx, NY",46834,10,1612,69086,-22252,0.68
 2019,Brooke,WV,"Brooke, WV",43210,0,514,22029,21181,1.96
 2020,Brooke,WV,"Brooke, WV",46858,8,418,17914,28944,2.62
 2021,Brooke,WV,"Brooke, WV",50271,7,696,29829,20442,1.69
 2019,Brookings,SD,"Brookings, SD",48112,0,1133,48557,-445,0.99
 2020,Brookings,SD,"Brookings, SD",51581,7,1216,52114,-533,0.99
 2021,Brookings,SD,"Brookings, SD",53860,4,1458,62486,-8626,0.86
 2019,Brooks,GA,"Brooks, GA",35010,0,674,28886,6124,1.21
 2020,Brooks,GA,"Brooks, GA",38394,10,763,32700,5694,1.17
 2021,Brooks,GA,"Brooks, GA",40982,7,945,40500,482,1.01
 2019,Brooks,TX,"Brooks, TX",36269,0,493,21129,15140,1.72
 2020,Brooks,TX,"Brooks, TX",40399,11,498,21343,19056,1.89
 2021,Brooks,TX,"Brooks, TX",43437,8,929,39814,3623,1.09
 2019,Broome,NY,"Broome, NY",43732,0,580,24857,18875,1.76
 2020,Broome,NY,"Broome, NY",47712,9,624,26743,20969,1.78
 2021,Broome,NY,"Broome, NY",50657,6,719,30814,19843,1.64
 2019,Broomfield,CO,"Broomfield, CO",67287,0,2781,119186,-51899,0.56
 2020,Broomfield,CO,"Broomfield, CO",66999,0,2768,118629,-51630,0.56
 2021,Broomfield,CO,"Broomfield, CO",73678,10,2876,123257,-49579,0.6
 2019,Broward,FL,"Broward, FL",54387,0,1533,65700,-11313,0.83
 2020,Broward,FL,"Broward, FL",57878,6,1576,67543,-9665,0.86
 2021,Broward,FL,"Broward, FL",64453,11,1482,63514,939,1.01
 2019,Brown,IL,"Brown, IL",38185,0,481,20614,17571,1.85
 2020,Brown,IL,"Brown, IL",42396,11,577,24729,17667,1.71
 2021,Brown,IL,"Brown, IL",44740,6,608,26057,18683,1.72
 2019,Brown,IN,"Brown, IN",48886,0,1497,64157,-15271,0.76
 2020,Brown,IN,"Brown, IN",51632,6,1499,64243,-12611,0.8
 2021,Brown,IN,"Brown, IN",55345,7,1976,84686,-29341,0.65
 2019,Brown,KS,"Brown, KS",45399,0,352,15086,30313,3.01
 2020,Brown,KS,"Brown, KS",48769,7,372,15943,32826,3.06
 2021,Brown,KS,"Brown, KS",51906,6,417,17871,34035,2.9
 2019,Brown,MN,"Brown, MN",52840,0,668,28629,24211,1.85
 2020,Brown,MN,"Brown, MN",57177,8,729,31243,25934,1.83
 2021,Brown,MN,"Brown, MN",60615,6,778,33343,27272,1.82
 2019,Brown,NE,"Brown, NE",56927,0,575,24643,32284,2.31
 2020,Brown,NE,"Brown, NE",63013,11,510,21857,41156,2.88
 2021,Brown,NE,"Brown, NE",63598,1,1062,45514,18084,1.4
 2019,Brown,OH,"Brown, OH",39149,0,721,30900,8249,1.27
 2020,Brown,OH,"Brown, OH",42639,9,739,31671,10968,1.35
 2021,Brown,OH,"Brown, OH",45795,7,1047,44871,924,1.02
 2019,Brown,SD,"Brown, SD",56126,0,989,42386,13740,1.32
 2020,Brown,SD,"Brown, SD",63550,13,868,37200,26350,1.71
 2021,Brown,SD,"Brown, SD",66044,4,1100,47143,18901,1.4
 2019,Brown,TX,"Brown, TX",40734,0,659,28243,12491,1.44
 2020,Brown,TX,"Brown, TX",43001,6,699,29957,13044,1.44
 2021,Brown,TX,"Brown, TX",46028,7,1080,46286,-258,0.99
 2019,Brown,WI,"Brown, WI",53415,0,1365,58500,-5085,0.91
 2020,Brown,WI,"Brown, WI",56305,5,1411,60471,-4166,0.93
 2021,Brown,WI,"Brown, WI",59279,5,1666,71400,-12121,0.83
 2019,Brule,SD,"Brule, SD",45995,0,563,24129,21866,1.91
 2020,Brule,SD,"Brule, SD",53397,16,648,27771,25626,1.92
 2021,Brule,SD,"Brule, SD",59267,11,997,42729,16538,1.39
 2019,Brunswick,NC,"Brunswick, NC",50004,0,1528,65486,-15482,0.76
 2020,Brunswick,NC,"Brunswick, NC",52706,5,1679,71957,-19251,0.73
 2021,Brunswick,NC,"Brunswick, NC",55361,5,1857,79586,-24225,0.7
 2019,Brunswick,VA,"Brunswick, VA",33612,0,1381,59186,-25574,0.57
 2020,Brunswick,VA,"Brunswick, VA",37119,10,1148,49200,-12081,0.75
 2021,Brunswick,VA,"Brunswick, VA",40151,8,1453,62271,-22120,0.64
 2019,Bryan,GA,"Bryan, GA",49390,0,1444,61886,-12496,0.8
 2020,Bryan,GA,"Bryan, GA",51580,4,1438,61629,-10049,0.84
 2021,Bryan,GA,"Bryan, GA",54772,6,1905,81643,-26871,0.67
 2019,Bryan,OK,"Bryan, OK",37796,0,976,41829,-4033,0.9
 2020,Bryan,OK,"Bryan, OK",40318,7,1110,47571,-7253,0.85
 2021,Bryan,OK,"Bryan, OK",43871,9,1272,54514,-10643,0.8
 2019,Buchanan,IA,"Buchanan, IA",49864,0,687,29443,20421,1.69
 2020,Buchanan,IA,"Buchanan, IA",52527,5,745,31929,20598,1.65
 2021,Buchanan,IA,"Buchanan, IA",57200,9,1005,43071,14129,1.33
 2019,Buchanan,MO,"Buchanan, MO",40780,0,513,21986,18794,1.85
 2020,Buchanan,MO,"Buchanan, MO",43594,7,503,21557,22037,2.02
 2021,Buchanan,MO,"Buchanan, MO",46362,6,476,20400,25962,2.27
 2019,Buchanan,VA,"Buchanan, VA",37586,0,618,26486,11100,1.42
 2020,Buchanan,VA,"Buchanan, VA",40138,7,613,26271,13867,1.53
 2021,Buchanan,VA,"Buchanan, VA",44003,10,755,32357,11646,1.36
 2019,Buckingham,VA,"Buckingham, VA",31098,0,786,33686,-2588,0.92
 2020,Buckingham,VA,"Buckingham, VA",33666,8,1175,50357,-16691,0.67
 2021,Buckingham,VA,"Buckingham, VA",37220,11,1646,70543,-33323,0.53
 2019,Bucks,PA,"Bucks, PA",75056,0,2049,87814,-12758,0.85
 2020,Bucks,PA,"Bucks, PA",79239,6,2301,98614,-19375,0.8
 2021,Bucks,PA,"Bucks, PA",83011,5,2519,107957,-24946,0.77
 2019,Buena Vista,IA,"Buena Vista, IA",42807,0,572,24514,18293,1.75
 2020,Buena Vista,IA,"Buena Vista, IA",45550,6,415,17786,27764,2.56
 2021,Buena Vista,IA,"Buena Vista, IA",49006,8,725,31071,17935,1.58
 2019,Buffalo,NE,"Buffalo, NE",56553,0,1030,44143,12410,1.28
 2020,Buffalo,NE,"Buffalo, NE",59369,5,1009,43243,16126,1.37
 2021,Buffalo,NE,"Buffalo, NE",61763,4,1317,56443,5320,1.09
 2020,Buffalo,SD,"Buffalo, SD",25764,28,1247,53443,-27679,0.48
 2021,Buffalo,SD,"Buffalo, SD",32773,27,1199,51386,-18613,0.64
 2019,Buffalo,WI,"Buffalo, WI",45734,0,667,28586,17148,1.6
 2020,Buffalo,WI,"Buffalo, WI",49202,8,773,33129,16073,1.49
 2021,Buffalo,WI,"Buffalo, WI",53031,8,650,27857,25174,1.9
 2019,Bullitt,KY,"Bullitt, KY",43527,0,1238,53057,-9530,0.82
 2020,Bullitt,KY,"Bullitt, KY",46834,8,1233,52843,-6009,0.89
 2021,Bullitt,KY,"Bullitt, KY",50169,7,1561,66900,-16731,0.75
 2019,Bulloch,GA,"Bulloch, GA",33054,0,820,35143,-2089,0.94
 2020,Bulloch,GA,"Bulloch, GA",35618,8,892,38229,-2611,0.93
 2021,Bulloch,GA,"Bulloch, GA",37901,6,1278,54771,-16870,0.69
 2019,Bullock,AL,"Bullock, AL",27192,0,1049,44957,-17765,0.6
 2020,Bullock,AL,"Bullock, AL",30429,12,489,20957,9472,1.45
 2021,Bullock,AL,"Bullock, AL",33267,9,1291,55329,-22062,0.6
 2019,Buncombe,NC,"Buncombe, NC",51095,0,1955,83786,-32691,0.61
 2020,Buncombe,NC,"Buncombe, NC",53944,6,2128,91200,-37256,0.59
 2021,Buncombe,NC,"Buncombe, NC",57895,7,2470,105857,-47962,0.55
 2019,Bureau,IL,"Bureau, IL",41467,0,497,21300,20167,1.95
 2020,Bureau,IL,"Bureau, IL",45938,11,464,19886,26052,2.31
 2021,Bureau,IL,"Bureau, IL",51269,12,687,29443,21826,1.74
 2019,Burke,GA,"Burke, GA",36082,0,857,36729,-647,0.98
 2020,Burke,GA,"Burke, GA",39207,9,801,34329,4878,1.14
 2021,Burke,GA,"Burke, GA",41870,7,950,40714,1156,1.03
 2019,Burke,NC,"Burke, NC",37922,0,1214,52029,-14107,0.73
 2020,Burke,NC,"Burke, NC",41229,9,1230,52714,-11485,0.78
 2021,Burke,NC,"Burke, NC",44798,9,1205,51643,-6845,0.87
 2019,Burke,ND,"Burke, ND",73848,0,423,18129,55719,4.07
 2020,Burke,ND,"Burke, ND",75228,2,254,10886,64342,6.91
 2021,Burke,ND,"Burke, ND",72515,-4,436,18686,53829,3.88
 2019,Burleigh,ND,"Burleigh, ND",60474,0,1394,59743,731,1.01
 2020,Burleigh,ND,"Burleigh, ND",62746,4,1439,61671,1075,1.02
 2021,Burleigh,ND,"Burleigh, ND",66017,5,1433,61414,4603,1.07
 2019,Burleson,TX,"Burleson, TX",50401,0,829,35529,14872,1.42
 2020,Burleson,TX,"Burleson, TX",52934,5,962,41229,11705,1.28
 2021,Burleson,TX,"Burleson, TX",57482,9,1261,54043,3439,1.06
 2019,Burlington,NJ,"Burlington, NJ",62113,0,1148,49200,12913,1.26
 2020,Burlington,NJ,"Burlington, NJ",65654,6,1255,53786,11868,1.22
 2021,Burlington,NJ,"Burlington, NJ",69496,6,1438,61629,7867,1.13
 2019,Burnet,TX,"Burnet, TX",53648,0,1924,82457,-28809,0.65
 2020,Burnet,TX,"Burnet, TX",55779,4,2184,93600,-37821,0.6
 2021,Burnet,TX,"Burnet, TX",59381,7,3480,149143,-89762,0.4
 2019,Burnett,WI,"Burnett, WI",43464,0,961,41186,2278,1.06
 2020,Burnett,WI,"Burnett, WI",46226,6,983,42129,4097,1.1
 2021,Burnett,WI,"Burnett, WI",49108,6,1208,51771,-2663,0.95
 2019,Burt,NE,"Burt, NE",47652,0,547,23443,24209,2.03
 2020,Burt,NE,"Burt, NE",52212,10,710,30429,21783,1.72
 2021,Burt,NE,"Burt, NE",56557,8,730,31286,25271,1.81
 2019,Butler,AL,"Butler, AL",39254,0,567,24300,14954,1.62
 2020,Butler,AL,"Butler, AL",41151,5,587,25157,15994,1.64
 2021,Butler,AL,"Butler, AL",46050,12,583,24986,21064,1.84
 2019,Butler,IA,"Butler, IA",46956,0,540,23143,23813,2.03
 2020,Butler,IA,"Butler, IA",49855,6,551,23614,26241,2.11
 2021,Butler,IA,"Butler, IA",57604,16,804,34457,23147,1.67
 2019,Butler,KS,"Butler, KS",47729,0,1017,43586,4143,1.1
 2020,Butler,KS,"Butler, KS",49703,4,819,35100,14603,1.42
 2021,Butler,KS,"Butler, KS",51643,4,1090,46714,4929,1.11
 2019,Butler,KY,"Butler, KY",35840,0,772,33086,2754,1.08
 2020,Butler,KY,"Butler, KY",39306,10,690,29571,9735,1.33
 2021,Butler,KY,"Butler, KY",43937,12,968,41486,2451,1.06
 2019,Butler,MO,"Butler, MO",36123,0,588,25200,10923,1.43
 2020,Butler,MO,"Butler, MO",40610,12,620,26571,14039,1.53
 2021,Butler,MO,"Butler, MO",43194,6,606,25971,17223,1.66
 2019,Butler,NE,"Butler, NE",48773,0,692,29657,19116,1.64
 2020,Butler,NE,"Butler, NE",55051,13,511,21900,33151,2.51
 2021,Butler,NE,"Butler, NE",59717,9,893,38271,21446,1.56
 2019,Butler,OH,"Butler, OH",49578,0,1119,47957,1621,1.03
 2020,Butler,OH,"Butler, OH",52403,6,1199,51386,1017,1.02
 2021,Butler,OH,"Butler, OH",55636,6,1166,49971,5665,1.11
 2019,Butler,PA,"Butler, PA",60060,0,1174,50314,9746,1.19
 2020,Butler,PA,"Butler, PA",63693,6,1421,60900,2793,1.05
 2021,Butler,PA,"Butler, PA",67203,6,1510,64714,2489,1.04
 2019,Butte,CA,"Butte, CA",46174,0,1627,69729,-23555,0.66
 2020,Butte,CA,"Butte, CA",51402,11,1810,77571,-26169,0.66
 2021,Butte,CA,"Butte, CA",54694,6,2155,92357,-37663,0.59
 2019,Butte,ID,"Butte, ID",44864,0,543,23271,21593,1.93
 2020,Butte,ID,"Butte, ID",49413,10,835,35786,13627,1.38
 2021,Butte,ID,"Butte, ID",48844,-1,1163,49843,-999,0.98
 2019,Butte,SD,"Butte, SD",40729,0,1278,54771,-14042,0.74
 2020,Butte,SD,"Butte, SD",44148,8,1110,47571,-3423,0.93
 2021,Butte,SD,"Butte, SD",45885,4,1365,58500,-12615,0.78
 2019,Butts,GA,"Butts, GA",35569,0,903,38700,-3131,0.92
 2020,Butts,GA,"Butts, GA",38057,7,1206,51686,-13629,0.74
 2021,Butts,GA,"Butts, GA",41657,10,1310,56143,-14486,0.74
 2019,Cabarrus,NC,"Cabarrus, NC",46415,0,1501,64329,-17914,0.72
 2020,Cabarrus,NC,"Cabarrus, NC",49592,7,1497,64157,-14565,0.77
 2021,Cabarrus,NC,"Cabarrus, NC",53647,8,1492,63943,-10296,0.84
 2019,Cabell,WV,"Cabell, WV",43680,0,620,26571,17109,1.64
 2020,Cabell,WV,"Cabell, WV",46506,7,561,24043,22463,1.93
 2021,Cabell,WV,"Cabell, WV",49866,7,543,23271,26595,2.14
 2019,Cache,UT,"Cache, UT",41127,0,1447,62014,-20887,0.66
 2020,Cache,UT,"Cache, UT",43253,5,1423,60986,-17733,0.71
 2021,Cache,UT,"Cache, UT",47269,9,2353,100843,-53574,0.47
 2019,Caddo,LA,"Caddo, LA",49516,0,835,35786,13730,1.38
 2020,Caddo,LA,"Caddo, LA",53120,7,816,34971,18149,1.52
 2021,Caddo,LA,"Caddo, LA",57420,8,727,31157,26263,1.84
 2019,Caddo,OK,"Caddo, OK",39266,0,490,21000,18266,1.87
 2020,Caddo,OK,"Caddo, OK",41445,6,452,19371,22074,2.14
 2021,Caddo,OK,"Caddo, OK",45452,10,533,22843,22609,1.99
 2019,Calaveras,CA,"Calaveras, CA",50310,0,1870,80143,-29833,0.63
 2020,Calaveras,CA,"Calaveras, CA",55355,10,1845,79071,-23716,0.7
 2021,Calaveras,CA,"Calaveras, CA",57726,4,2682,114943,-57217,0.5
 2019,Calcasieu,LA,"Calcasieu, LA",45824,0,1129,48386,-2562,0.95
 2020,Calcasieu,LA,"Calcasieu, LA",47033,3,1050,45000,2033,1.05
 2021,Calcasieu,LA,"Calcasieu, LA",50775,8,1038,44486,6289,1.14
 2019,Caldwell,KY,"Caldwell, KY",35646,0,697,29871,5775,1.19
 2020,Caldwell,KY,"Caldwell, KY",40176,13,631,27043,13133,1.49
 2021,Caldwell,KY,"Caldwell, KY",44963,12,718,30771,14192,1.46
 2019,Caldwell,LA,"Caldwell, LA",35695,0,632,27086,8609,1.32
 2020,Caldwell,LA,"Caldwell, LA",39210,10,661,28329,10881,1.38
 2021,Caldwell,LA,"Caldwell, LA",42049,7,1528,65486,-23437,0.64
 2019,Caldwell,MO,"Caldwell, MO",39967,0,565,24214,15753,1.65
 2020,Caldwell,MO,"Caldwell, MO",42976,8,716,30686,12290,1.4
 2021,Caldwell,MO,"Caldwell, MO",45802,7,904,38743,7059,1.18
 2019,Caldwell,NC,"Caldwell, NC",37207,0,1067,45729,-8522,0.81
 2020,Caldwell,NC,"Caldwell, NC",40147,8,1172,50229,-10082,0.8
 2021,Caldwell,NC,"Caldwell, NC",43856,9,1270,54429,-10573,0.81
 2019,Caldwell,TX,"Caldwell, TX",34368,0,1258,53914,-19546,0.64
 2020,Caldwell,TX,"Caldwell, TX",37189,8,1231,52757,-15568,0.7
 2021,Caldwell,TX,"Caldwell, TX",41642,12,1998,85629,-43987,0.49
 2019,Caledonia,VT,"Caledonia, VT",43758,0,940,40286,3472,1.09
 2020,Caledonia,VT,"Caledonia, VT",48202,10,944,40457,7745,1.19
 2021,Caledonia,VT,"Caledonia, VT",50533,5,995,42643,7890,1.19
 2019,Calhoun,AL,"Calhoun, AL",36869,0,579,24814,12055,1.49
 2020,Calhoun,AL,"Calhoun, AL",39546,7,671,28757,10789,1.38
 2021,Calhoun,AL,"Calhoun, AL",42621,8,732,31371,11250,1.36
 2019,Calhoun,AR,"Calhoun, AR",38581,0,349,14957,23624,2.58
 2020,Calhoun,AR,"Calhoun, AR",42102,9,598,25629,16473,1.64
 2021,Calhoun,AR,"Calhoun, AR",45401,8,360,15429,29972,2.94
 2019,Calhoun,FL,"Calhoun, FL",30016,0,951,40757,-10741,0.74
 2020,Calhoun,FL,"Calhoun, FL",33042,10,985,42214,-9172,0.78
 2021,Calhoun,FL,"Calhoun, FL",35792,8,1242,53229,-17437,0.67
 2019,Calhoun,GA,"Calhoun, GA",28906,0,433,18557,10349,1.56
 2020,Calhoun,GA,"Calhoun, GA",31898,10,251,10757,21141,2.97
 2021,Calhoun,GA,"Calhoun, GA",34306,8,1017,43586,-9280,0.79
 2019,Calhoun,IA,"Calhoun, IA",47897,0,473,20271,27626,2.36
 2020,Calhoun,IA,"Calhoun, IA",50233,5,371,15900,34333,3.16
 2021,Calhoun,IA,"Calhoun, IA",57289,14,672,28800,28489,1.99
 2019,Calhoun,IL,"Calhoun, IL",44902,0,527,22586,22316,1.99
 2020,Calhoun,IL,"Calhoun, IL",49809,11,569,24386,25423,2.04
 2021,Calhoun,IL,"Calhoun, IL",55240,11,529,22671,32569,2.44
 2019,Calhoun,MI,"Calhoun, MI",40497,0,647,27729,12768,1.46
 2020,Calhoun,MI,"Calhoun, MI",44796,11,682,29229,15567,1.53
 2021,Calhoun,MI,"Calhoun, MI",47789,7,768,32914,14875,1.45
 2019,Calhoun,MS,"Calhoun, MS",35831,0,422,18086,17745,1.98
 2020,Calhoun,MS,"Calhoun, MS",40299,13,465,19929,20370,2.02
 2021,Calhoun,MS,"Calhoun, MS",43222,7,654,28029,15193,1.54
 2019,Calhoun,SC,"Calhoun, SC",43214,0,1061,45471,-2257,0.95
 2020,Calhoun,SC,"Calhoun, SC",46304,7,1260,54000,-7696,0.86
 2021,Calhoun,SC,"Calhoun, SC",50375,9,1114,47743,2632,1.06
 2019,Calhoun,TX,"Calhoun, TX",56746,0,1253,53700,3046,1.06
 2020,Calhoun,TX,"Calhoun, TX",58732,4,1171,50186,8546,1.17
 2021,Calhoun,TX,"Calhoun, TX",60589,3,1228,52629,7960,1.15
 2019,Calhoun,WV,"Calhoun, WV",35162,0,480,20571,14591,1.71
 2020,Calhoun,WV,"Calhoun, WV",38841,11,356,15257,23584,2.55
 2021,Calhoun,WV,"Calhoun, WV",41444,7,689,29529,11915,1.4
 2019,Callahan,TX,"Callahan, TX",45861,0,680,29143,16718,1.57
 2020,Callahan,TX,"Callahan, TX",48266,5,734,31457,16809,1.53
 2021,Callahan,TX,"Callahan, TX",50963,6,972,41657,9306,1.22
 2019,Callaway,MO,"Callaway, MO",40115,0,772,33086,7029,1.21
 2020,Callaway,MO,"Callaway, MO",43671,9,822,35229,8442,1.24
 2021,Callaway,MO,"Callaway, MO",46191,6,961,41186,5005,1.12
 2019,Calloway,KY,"Calloway, KY",38546,0,884,37886,660,1.02
 2020,Calloway,KY,"Calloway, KY",42036,9,982,42086,-50,1
 2021,Calloway,KY,"Calloway, KY",44116,5,1150,49286,-5170,0.9
 2019,Calumet,WI,"Calumet, WI",51380,0,1273,54557,-3177,0.94
 2020,Calumet,WI,"Calumet, WI",54031,5,1289,55243,-1212,0.98
 2021,Calumet,WI,"Calumet, WI",57182,6,1446,61971,-4789,0.92
 2019,Calvert,MD,"Calvert, MD",63780,0,1741,74614,-10834,0.85
 2020,Calvert,MD,"Calvert, MD",66872,5,1843,78986,-12114,0.85
 2021,Calvert,MD,"Calvert, MD",70690,6,1838,78771,-8081,0.9
 2019,Camas,ID,"Camas, ID",54184,0,1289,55243,-1059,0.98
 2020,Camas,ID,"Camas, ID",59629,10,1472,63086,-3457,0.95
 2021,Camas,ID,"Camas, ID",62248,4,1723,73843,-11595,0.84
 2019,Cambria,PA,"Cambria, PA",43120,0,347,14871,28249,2.9
 2020,Cambria,PA,"Cambria, PA",46609,8,370,15857,30752,2.94
 2021,Cambria,PA,"Cambria, PA",49472,6,461,19757,29715,2.5
 2019,Camden,GA,"Camden, GA",37169,0,1039,44529,-7360,0.83
 2020,Camden,GA,"Camden, GA",39729,7,1207,51729,-12000,0.77
 2021,Camden,GA,"Camden, GA",42945,8,1543,66129,-23184,0.65
 2019,Camden,MO,"Camden, MO",42487,0,1217,52157,-9670,0.81
 2020,Camden,MO,"Camden, MO",46149,9,1326,56829,-10680,0.81
 2021,Camden,MO,"Camden, MO",53779,17,1988,85200,-31421,0.63
 2019,Camden,NC,"Camden, NC",49318,0,1426,61114,-11796,0.81
 2020,Camden,NC,"Camden, NC",52032,6,1475,63214,-11182,0.82
 2021,Camden,NC,"Camden, NC",55457,7,1851,79329,-23872,0.7
 2019,Camden,NJ,"Camden, NJ",53811,0,873,37414,16397,1.44
 2020,Camden,NJ,"Camden, NJ",57483,7,967,41443,16040,1.39
 2021,Camden,NJ,"Camden, NJ",61642,7,1198,51343,10299,1.2
 2019,Cameron,LA,"Cameron, LA",57177,0,1392,59657,-2480,0.96
 2020,Cameron,LA,"Cameron, LA",58059,2,1673,71700,-13641,0.81
 2021,Cameron,LA,"Cameron, LA",63384,9,1500,64286,-902,0.99
 2019,Cameron,PA,"Cameron, PA",46309,0,339,14529,31780,3.19
 2020,Cameron,PA,"Cameron, PA",51527,11,294,12600,38927,4.09
 2021,Cameron,PA,"Cameron, PA",54352,6,605,25929,28423,2.1
 2019,Cameron,TX,"Cameron, TX",30361,0,1038,44486,-14125,0.68
 2020,Cameron,TX,"Cameron, TX",34040,12,1162,49800,-15760,0.68
 2021,Cameron,TX,"Cameron, TX",37861,11,1403,60129,-22268,0.63
 2019,Camp,TX,"Camp, TX",39703,0,1126,48257,-8554,0.82
 2020,Camp,TX,"Camp, TX",42896,8,1250,53571,-10675,0.8
 2021,Camp,TX,"Camp, TX",46705,9,1266,54257,-7552,0.86
 2019,Campbell,KY,"Campbell, KY",51621,0,983,42129,9492,1.23
 2020,Campbell,KY,"Campbell, KY",55115,7,1426,61114,-5999,0.9
 2021,Campbell,KY,"Campbell, KY",58701,7,1785,76500,-17799,0.77
 2019,Campbell,SD,"Campbell, SD",46144,0,1051,45043,1101,1.02
 2020,Campbell,SD,"Campbell, SD",67948,47,143,6129,61819,11.09
 2021,Campbell,SD,"Campbell, SD",79723,17,654,28029,51694,2.84
 2019,Campbell,TN,"Campbell, TN",35824,0,917,39300,-3476,0.91
 2020,Campbell,TN,"Campbell, TN",38706,8,900,38571,135,1
 2021,Campbell,TN,"Campbell, TN",42471,10,1264,54171,-11700,0.78
 2019,Campbell,WY,"Campbell, WY",53876,0,1006,43114,10762,1.25
 2020,Campbell,WY,"Campbell, WY",54040,0,1033,44271,9769,1.22
 2021,Campbell,WY,"Campbell, WY",56008,4,1152,49371,6637,1.13
 2019,Canadian,OK,"Canadian, OK",46536,0,1061,45471,1065,1.02
 2020,Canadian,OK,"Canadian, OK",47987,3,1100,47143,844,1.02
 2021,Canadian,OK,"Canadian, OK",50309,5,1288,55200,-4891,0.91
 2019,Cannon,TN,"Cannon, TN",37663,0,888,38057,-394,0.99
 2020,Cannon,TN,"Cannon, TN",40263,7,1107,47443,-7180,0.85
 2021,Cannon,TN,"Cannon, TN",44419,10,1636,70114,-25695,0.63
 2019,Canyon,ID,"Canyon, ID",35791,0,1298,55629,-19838,0.64
 2020,Canyon,ID,"Canyon, ID",39017,9,1493,63986,-24969,0.61
 2021,Canyon,ID,"Canyon, ID",41980,8,2008,86057,-44077,0.49
 2019,Cape Girardeau,MO,"Cape Girardeau, MO",43856,0,852,36514,7342,1.2
 2020,Cape Girardeau,MO,"Cape Girardeau, MO",46449,6,879,37671,8778,1.23
 2021,Cape Girardeau,MO,"Cape Girardeau, MO",48732,5,1147,49157,-425,0.99
 2019,Cape May,NJ,"Cape May, NJ",63302,0,2098,89914,-26612,0.7
 2020,Cape May,NJ,"Cape May, NJ",68326,8,2333,99986,-31660,0.68
 2021,Cape May,NJ,"Cape May, NJ",72010,5,2883,123557,-51547,0.58
 2019,Carbon,MT,"Carbon, MT",55564,0,1840,78857,-23293,0.7
 2020,Carbon,MT,"Carbon, MT",58553,5,1969,84386,-25833,0.69
 2021,Carbon,MT,"Carbon, MT",59715,2,3842,164657,-104942,0.36
 2019,Carbon,PA,"Carbon, PA",52818,0,754,32314,20504,1.63
 2020,Carbon,PA,"Carbon, PA",56231,7,872,37371,18860,1.5
 2021,Carbon,PA,"Carbon, PA",59317,6,1132,48514,10803,1.22
 2019,Carbon,UT,"Carbon, UT",40448,0,647,27729,12719,1.46
 2020,Carbon,UT,"Carbon, UT",42848,6,776,33257,9591,1.29
 2021,Carbon,UT,"Carbon, UT",45120,5,997,42729,2391,1.06
 2019,Carbon,WY,"Carbon, WY",58619,0,826,35400,23219,1.66
 2020,Carbon,WY,"Carbon, WY",62318,6,832,35657,26661,1.75
 2021,Carbon,WY,"Carbon, WY",64804,4,843,36129,28675,1.79
 2019,Caribou,ID,"Caribou, ID",43080,0,822,35229,7851,1.22
 2020,Caribou,ID,"Caribou, ID",47824,11,1017,43586,4238,1.1
 2021,Caribou,ID,"Caribou, ID",47740,0,1379,59100,-11360,0.81
 2019,Carlisle,KY,"Carlisle, KY",43968,0,429,18386,25582,2.39
 2020,Carlisle,KY,"Carlisle, KY",46005,5,345,14786,31219,3.11
 2021,Carlisle,KY,"Carlisle, KY",52638,14,419,17957,34681,2.93
 2019,Carlton,MN,"Carlton, MN",43646,0,1015,43500,146,1
 2020,Carlton,MN,"Carlton, MN",46796,7,1117,47871,-1075,0.98
 2021,Carlton,MN,"Carlton, MN",49797,6,1166,49971,-174,1
 2019,Caroline,MD,"Caroline, MD",46197,0,1135,48643,-2446,0.95
 2020,Caroline,MD,"Caroline, MD",48287,5,1164,49886,-1599,0.97
 2021,Caroline,MD,"Caroline, MD",53549,11,1498,64200,-10651,0.83
 2019,Caroline,VA,"Caroline, VA",43232,0,1171,50186,-6954,0.86
 2020,Caroline,VA,"Caroline, VA",46568,8,1295,55500,-8932,0.84
 2021,Caroline,VA,"Caroline, VA",49650,7,1669,71529,-21879,0.69
 2019,Carroll,AR,"Carroll, AR",32829,0,1093,46843,-14014,0.7
 2020,Carroll,AR,"Carroll, AR",34896,6,1286,55114,-20218,0.63
 2021,Carroll,AR,"Carroll, AR",40689,17,1698,72771,-32082,0.56
 2019,Carroll,GA,"Carroll, GA",40663,0,1019,43671,-3008,0.93
 2020,Carroll,GA,"Carroll, GA",44014,8,1140,48857,-4843,0.9
 2021,Carroll,GA,"Carroll, GA",47002,7,1527,65443,-18441,0.72
 2019,Carroll,IA,"Carroll, IA",52526,0,781,33471,19055,1.57
 2020,Carroll,IA,"Carroll, IA",54851,4,707,30300,24551,1.81
 2021,Carroll,IA,"Carroll, IA",60290,10,862,36943,23347,1.63
 2019,Carroll,IL,"Carroll, IL",40903,0,676,28971,11932,1.41
 2020,Carroll,IL,"Carroll, IL",45742,12,667,28586,17156,1.6
 2021,Carroll,IL,"Carroll, IL",49976,9,649,27814,22162,1.8
 2019,Carroll,IN,"Carroll, IN",43495,0,795,34071,9424,1.28
 2020,Carroll,IN,"Carroll, IN",47182,9,705,30214,16968,1.56
 2021,Carroll,IN,"Carroll, IN",51293,9,979,41957,9336,1.22
 2019,Carroll,KY,"Carroll, KY",37994,0,657,28157,9837,1.35
 2020,Carroll,KY,"Carroll, KY",41578,9,721,30900,10678,1.35
 2021,Carroll,KY,"Carroll, KY",45317,9,1085,46500,-1183,0.97
 2019,Carroll,MD,"Carroll, MD",62251,0,1777,76157,-13906,0.82
 2020,Carroll,MD,"Carroll, MD",65635,5,1858,79629,-13994,0.82
 2021,Carroll,MD,"Carroll, MD",69397,6,1994,85457,-16060,0.81
 2019,Carroll,MO,"Carroll, MO",47192,0,489,20957,26235,2.25
 2020,Carroll,MO,"Carroll, MO",51232,9,302,12943,38289,3.96
 2021,Carroll,MO,"Carroll, MO",54784,7,693,29700,25084,1.84
 2019,Carroll,MS,"Carroll, MS",37776,0,778,33343,4433,1.13
 2020,Carroll,MS,"Carroll, MS",41232,9,1203,51557,-10325,0.8
 2021,Carroll,MS,"Carroll, MS",44908,9,911,39043,5865,1.15
 2019,Carroll,NH,"Carroll, NH",63343,0,1536,65829,-2486,0.96
 2020,Carroll,NH,"Carroll, NH",66897,6,1571,67329,-432,0.99
 2021,Carroll,NH,"Carroll, NH",69803,4,2020,86571,-16768,0.81
 2019,Carroll,OH,"Carroll, OH",41253,0,810,34714,6539,1.19
 2020,Carroll,OH,"Carroll, OH",45217,10,818,35057,10160,1.29
 2021,Carroll,OH,"Carroll, OH",48319,7,965,41357,6962,1.17
 2019,Carroll,TN,"Carroll, TN",36312,0,726,31114,5198,1.17
 2020,Carroll,TN,"Carroll, TN",37686,4,615,26357,11329,1.43
 2021,Carroll,TN,"Carroll, TN",40502,8,1016,43543,-3041,0.93
 2019,Carson City,NV,"Carson City, NV",50973,0,1902,81514,-30541,0.63
 2020,Carson City,NV,"Carson City, NV",55239,8,1700,72857,-17618,0.76
 2021,Carson City,NV,"Carson City, NV",60445,9,2571,110186,-49741,0.55
 2019,Carson,TX,"Carson, TX",48921,0,585,25071,23850,1.95
 2020,Carson,TX,"Carson, TX",47782,-2,464,19886,27896,2.4
 2021,Carson,TX,"Carson, TX",56357,18,570,24429,31928,2.31
 2019,Carter,KY,"Carter, KY",31838,0,630,27000,4838,1.18
 2020,Carter,KY,"Carter, KY",36134,14,576,24686,11448,1.46
 2021,Carter,KY,"Carter, KY",39323,9,812,34800,4523,1.13
 2019,Carter,MO,"Carter, MO",38969,0,745,31929,7040,1.22
 2020,Carter,MO,"Carter, MO",42787,10,713,30557,12230,1.4
 2021,Carter,MO,"Carter, MO",45237,6,1470,63000,-17763,0.72
 2020,Carter,MT,"Carter, MT",41071,16,1151,49329,-8258,0.83
 2021,Carter,MT,"Carter, MT",39354,-4,408,17486,21868,2.25
 2019,Carter,OK,"Carter, OK",43831,0,744,31886,11945,1.37
 2020,Carter,OK,"Carter, OK",45673,4,836,35829,9844,1.27
 2021,Carter,OK,"Carter, OK",48733,7,853,36557,12176,1.33
 2019,Carter,TN,"Carter, TN",35153,0,798,34200,953,1.03
 2020,Carter,TN,"Carter, TN",37632,7,998,42771,-5139,0.88
 2021,Carter,TN,"Carter, TN",40739,8,1261,54043,-13304,0.75
 2019,Carteret,NC,"Carteret, NC",53601,0,1649,70671,-17070,0.76
 2020,Carteret,NC,"Carteret, NC",57329,7,1799,77100,-19771,0.74
 2021,Carteret,NC,"Carteret, NC",60741,6,2165,92786,-32045,0.65
 2019,Carver,MN,"Carver, MN",73785,0,2039,87386,-13601,0.84
 2020,Carver,MN,"Carver, MN",76137,3,1982,84943,-8806,0.9
 2021,Carver,MN,"Carver, MN",80562,6,2110,90429,-9867,0.89
 2019,Cascade,MT,"Cascade, MT",47303,0,1078,46200,1103,1.02
 2020,Cascade,MT,"Cascade, MT",50576,7,1146,49114,1462,1.03
 2021,Cascade,MT,"Cascade, MT",53765,6,1470,63000,-9235,0.85
 2019,Casey,KY,"Casey, KY",32161,0,666,28543,3618,1.13
 2020,Casey,KY,"Casey, KY",36825,15,814,34886,1939,1.06
 2021,Casey,KY,"Casey, KY",40837,11,1021,43757,-2920,0.93
 2019,Cass,IA,"Cass, IA",47870,0,471,20186,27684,2.37
 2020,Cass,IA,"Cass, IA",50517,6,539,23100,27417,2.19
 2021,Cass,IA,"Cass, IA",55056,9,587,25157,29899,2.19
 2019,Cass,IL,"Cass, IL",38418,0,488,20914,17504,1.84
 2020,Cass,IL,"Cass, IL",44095,15,420,18000,26095,2.45
 2021,Cass,IL,"Cass, IL",48959,11,599,25671,23288,1.91
 2019,Cass,IN,"Cass, IN",39944,0,425,18214,21730,2.19
 2020,Cass,IN,"Cass, IN",43741,10,417,17871,25870,2.45
 2021,Cass,IN,"Cass, IN",47854,9,493,21129,26725,2.26
 2019,Cass,MI,"Cass, MI",45827,0,1110,47571,-1744,0.96
 2020,Cass,MI,"Cass, MI",51045,11,1108,47486,3559,1.07
 2021,Cass,MI,"Cass, MI",56042,10,1363,58414,-2372,0.96
 2019,Cass,MN,"Cass, MN",47869,0,1310,56143,-8274,0.85
 2020,Cass,MN,"Cass, MN",51803,8,1367,58586,-6783,0.88
 2021,Cass,MN,"Cass, MN",56491,9,1742,74657,-18166,0.76
 2019,Cass,MO,"Cass, MO",48865,0,1357,58157,-9292,0.84
 2020,Cass,MO,"Cass, MO",51409,5,1495,64071,-12662,0.8
 2021,Cass,MO,"Cass, MO",54020,5,1548,66343,-12323,0.81
 2019,Cass,ND,"Cass, ND",58233,0,1266,54257,3976,1.07
 2020,Cass,ND,"Cass, ND",61736,6,1189,50957,10779,1.21
 2021,Cass,ND,"Cass, ND",65803,7,1655,70929,-5126,0.93
 2019,Cass,NE,"Cass, NE",53565,0,1211,51900,1665,1.03
 2020,Cass,NE,"Cass, NE",56967,6,1244,53314,3653,1.07
 2021,Cass,NE,"Cass, NE",60920,7,1295,55500,5420,1.1
 2019,Cass,TX,"Cass, TX",39831,0,575,24643,15188,1.62
 2020,Cass,TX,"Cass, TX",43281,9,670,28714,14567,1.51
 2021,Cass,TX,"Cass, TX",46101,7,913,39129,6972,1.18
 2019,Cassia,ID,"Cassia, ID",45152,0,1021,43757,1395,1.03
 2020,Cassia,ID,"Cassia, ID",48220,7,1238,53057,-4837,0.91
 2021,Cassia,ID,"Cassia, ID",47780,-1,1679,71957,-24177,0.66
 2019,Castro,TX,"Castro, TX",66556,0,812,34800,31756,1.91
 2020,Castro,TX,"Castro, TX",75830,14,492,21086,54744,3.6
 2021,Castro,TX,"Castro, TX",81900,8,845,36214,45686,2.26
 2019,Caswell,NC,"Caswell, NC",35982,0,910,39000,-3018,0.92
 2020,Caswell,NC,"Caswell, NC",38866,8,1140,48857,-9991,0.8
 2021,Caswell,NC,"Caswell, NC",42247,9,1339,57386,-15139,0.74
 2019,Catahoula,LA,"Catahoula, LA",35868,0,660,28286,7582,1.27
 2020,Catahoula,LA,"Catahoula, LA",40839,14,739,31671,9168,1.29
 2021,Catahoula,LA,"Catahoula, LA",43386,6,846,36257,7129,1.2
 2019,Catawba,NC,"Catawba, NC",46269,0,1330,57000,-10731,0.81
 2020,Catawba,NC,"Catawba, NC",49400,7,1376,58971,-9571,0.84
 2021,Catawba,NC,"Catawba, NC",53333,8,1386,59400,-6067,0.9
 2019,Catoosa,GA,"Catoosa, GA",36389,0,1106,47400,-11011,0.77
 2020,Catoosa,GA,"Catoosa, GA",39530,9,1160,49714,-10184,0.8
 2021,Catoosa,GA,"Catoosa, GA",42448,7,1429,61243,-18795,0.69
 2019,Catron,NM,"Catron, NM",33162,0,944,40457,-7295,0.82
 2020,Catron,NM,"Catron, NM",36786,11,961,41186,-4400,0.89
 2021,Catron,NM,"Catron, NM",37990,3,1650,70714,-32724,0.54
 2019,Cattaraugus,NY,"Cattaraugus, NY",40704,0,595,25500,15204,1.6
 2020,Cattaraugus,NY,"Cattaraugus, NY",44629,10,749,32100,12529,1.39
 2021,Cattaraugus,NY,"Cattaraugus, NY",46775,5,612,26229,20546,1.78
 2019,Cavalier,ND,"Cavalier, ND",63525,0,987,42300,21225,1.5
 2020,Cavalier,ND,"Cavalier, ND",90480,42,819,35100,55380,2.58
 2021,Cavalier,ND,"Cavalier, ND",88700,-2,395,16929,71771,5.24
 2019,Cayuga,NY,"Cayuga, NY",44668,0,797,34157,10511,1.31
 2020,Cayuga,NY,"Cayuga, NY",48654,9,832,35657,12997,1.36
 2021,Cayuga,NY,"Cayuga, NY",51431,6,1028,44057,7374,1.17
 2019,Cecil,MD,"Cecil, MD",49070,0,1312,56229,-7159,0.87
 2020,Cecil,MD,"Cecil, MD",51681,5,1379,59100,-7419,0.87
 2021,Cecil,MD,"Cecil, MD",55293,7,1538,65914,-10621,0.84
 2019,Cedar,IA,"Cedar, IA",54246,0,784,33600,20646,1.61
 2020,Cedar,IA,"Cedar, IA",56933,5,892,38229,18704,1.49
 2021,Cedar,IA,"Cedar, IA",63197,11,845,36214,26983,1.75
 2019,Cedar,MO,"Cedar, MO",31770,0,413,17700,14070,1.79
 2020,Cedar,MO,"Cedar, MO",34960,10,562,24086,10874,1.45
 2021,Cedar,MO,"Cedar, MO",36748,5,610,26143,10605,1.41
 2019,Cedar,NE,"Cedar, NE",51013,0,692,29657,21356,1.72
 2020,Cedar,NE,"Cedar, NE",58553,15,567,24300,34253,2.41
 2021,Cedar,NE,"Cedar, NE",66572,14,714,30600,35972,2.18
 2019,Centre,PA,"Centre, PA",49211,0,1309,56100,-6889,0.88
 2020,Centre,PA,"Centre, PA",52699,7,1355,58071,-5372,0.91
 2021,Centre,PA,"Centre, PA",54994,4,1392,59657,-4663,0.92
 2019,Cerro Gordo,IA,"Cerro Gordo, IA",50012,0,714,30600,19412,1.63
 2020,Cerro Gordo,IA,"Cerro Gordo, IA",53478,7,793,33986,19492,1.57
 2021,Cerro Gordo,IA,"Cerro Gordo, IA",56955,7,769,32957,23998,1.73
 2019,Chaffee,CO,"Chaffee, CO",53607,0,2396,102686,-49079,0.52
 2020,Chaffee,CO,"Chaffee, CO",56878,6,2646,113400,-56522,0.5
 2021,Chaffee,CO,"Chaffee, CO",60550,7,3372,144514,-83964,0.42
 2019,Chambers,AL,"Chambers, AL",33682,0,440,18857,14825,1.79
 2020,Chambers,AL,"Chambers, AL",36299,8,542,23229,13070,1.56
 2021,Chambers,AL,"Chambers, AL",39728,9,714,30600,9128,1.3
 2019,Chambers,TX,"Chambers, TX",57391,0,1426,61114,-3723,0.94
 2020,Chambers,TX,"Chambers, TX",58687,2,1492,63943,-5256,0.92
 2021,Chambers,TX,"Chambers, TX",60591,3,1628,69771,-9180,0.87
 2019,Champaign,IL,"Champaign, IL",46769,0,892,38229,8540,1.22
 2020,Champaign,IL,"Champaign, IL",50839,9,895,38357,12482,1.33
 2021,Champaign,IL,"Champaign, IL",54638,8,909,38957,15681,1.4
 2019,Champaign,OH,"Champaign, OH",42488,0,671,28757,13731,1.48
 2020,Champaign,OH,"Champaign, OH",47064,11,686,29400,17664,1.6
 2021,Champaign,OH,"Champaign, OH",50151,7,857,36729,13422,1.37
 2019,Chariton,MO,"Chariton, MO",44366,0,674,28886,15480,1.54
 2020,Chariton,MO,"Chariton, MO",48933,10,541,23186,25747,2.11
 2021,Chariton,MO,"Chariton, MO",51590,5,1074,46029,5561,1.12
 2019,Charles City,VA,"Charles City, VA",49966,0,1328,56914,-6948,0.88
 2020,Charles City,VA,"Charles City, VA",54456,9,1580,67714,-13258,0.8
 2021,Charles City,VA,"Charles City, VA",58882,8,1946,83400,-24518,0.71
 2019,Charles Mix,SD,"Charles Mix, SD",40561,0,709,30386,10175,1.33
 2020,Charles Mix,SD,"Charles Mix, SD",45485,12,706,30257,15228,1.5
 2021,Charles Mix,SD,"Charles Mix, SD",50673,11,1074,46029,4644,1.1
 2019,Charles,MD,"Charles, MD",56518,0,1645,70500,-13982,0.8
 2020,Charles,MD,"Charles, MD",60334,7,1759,75386,-15052,0.8
 2021,Charles,MD,"Charles, MD",63939,6,2000,85714,-21775,0.75
 2019,Charleston,SC,"Charleston, SC",67053,0,2470,105857,-38804,0.63
 2020,Charleston,SC,"Charleston, SC",68720,3,2638,113057,-44337,0.61
 2021,Charleston,SC,"Charleston, SC",73032,6,3107,133157,-60125,0.55
 2019,Charlevoix,MI,"Charlevoix, MI",53854,0,1584,67886,-14032,0.79
 2020,Charlevoix,MI,"Charlevoix, MI",59153,10,1458,62486,-3333,0.95
 2021,Charlevoix,MI,"Charlevoix, MI",62505,6,1752,75086,-12581,0.83
 2019,Charlotte,FL,"Charlotte, FL",46707,0,1339,57386,-10679,0.81
 2020,Charlotte,FL,"Charlotte, FL",49052,5,1385,59357,-10305,0.83
 2021,Charlotte,FL,"Charlotte, FL",51677,5,1878,80486,-28809,0.64
 2019,Charlotte,VA,"Charlotte, VA",36525,0,702,30086,6439,1.21
 2020,Charlotte,VA,"Charlotte, VA",39448,8,946,40543,-1095,0.97
 2021,Charlotte,VA,"Charlotte, VA",43870,11,1641,70329,-26459,0.62
 2019,Charlton,GA,"Charlton, GA",26630,0,1064,45600,-18970,0.58
 2020,Charlton,GA,"Charlton, GA",29062,9,1073,45986,-16924,0.63
 2021,Charlton,GA,"Charlton, GA",30916,6,906,38829,-7913,0.8
 2019,Chase,KS,"Chase, KS",53672,0,526,22543,31129,2.38
 2020,Chase,KS,"Chase, KS",63086,18,487,20871,42215,3.02
 2021,Chase,KS,"Chase, KS",64717,3,694,29743,34974,2.18
 2019,Chase,NE,"Chase, NE",60268,0,854,36600,23668,1.65
 2020,Chase,NE,"Chase, NE",68404,14,703,30129,38275,2.27
 2021,Chase,NE,"Chase, NE",69366,1,749,32100,37266,2.16
 2019,Chatham,GA,"Chatham, GA",47724,0,1402,60086,-12362,0.79
 2020,Chatham,GA,"Chatham, GA",51482,8,1557,66729,-15247,0.77
 2021,Chatham,GA,"Chatham, GA",54586,6,1582,67800,-13214,0.81
 2019,Chatham,NC,"Chatham, NC",67117,0,2581,110614,-43497,0.61
 2020,Chatham,NC,"Chatham, NC",70130,5,2629,112671,-42541,0.62
 2021,Chatham,NC,"Chatham, NC",75624,8,3471,148757,-73133,0.51
 2019,Chattahoochee,GA,"Chattahoochee, GA",32636,0,373,15986,16650,2.04
 2020,Chattahoochee,GA,"Chattahoochee, GA",36007,10,566,24257,11750,1.48
 2021,Chattahoochee,GA,"Chattahoochee, GA",39690,10,462,19800,19890,2
 2019,Chattooga,GA,"Chattooga, GA",31192,0,718,30771,421,1.01
 2020,Chattooga,GA,"Chattooga, GA",33948,9,578,24771,9177,1.37
 2021,Chattooga,GA,"Chattooga, GA",36833,9,1246,53400,-16567,0.69
 2019,Chautauqua,KS,"Chautauqua, KS",39345,0,178,7629,31716,5.16
 2020,Chautauqua,KS,"Chautauqua, KS",42504,8,333,14271,28233,2.98
 2021,Chautauqua,KS,"Chautauqua, KS",45394,7,790,33857,11537,1.34
 2019,Chautauqua,NY,"Chautauqua, NY",41237,0,697,29871,11366,1.38
 2020,Chautauqua,NY,"Chautauqua, NY",44998,9,714,30600,14398,1.47
 2021,Chautauqua,NY,"Chautauqua, NY",47642,6,747,32014,15628,1.49
 2019,Chaves,NM,"Chaves, NM",39757,0,953,40843,-1086,0.97
 2020,Chaves,NM,"Chaves, NM",42594,7,883,37843,4751,1.13
 2021,Chaves,NM,"Chaves, NM",45577,7,962,41229,4348,1.11
 2019,Cheatham,TN,"Cheatham, TN",47099,0,1256,53829,-6730,0.87
 2020,Cheatham,TN,"Cheatham, TN",49389,5,1326,56829,-7440,0.87
 2021,Cheatham,TN,"Cheatham, TN",54069,10,1893,81129,-27060,0.67
 2019,Cheboygan,MI,"Cheboygan, MI",40691,0,937,40157,534,1.01
 2020,Cheboygan,MI,"Cheboygan, MI",45719,12,969,41529,4190,1.1
 2021,Cheboygan,MI,"Cheboygan, MI",48078,5,1337,57300,-9222,0.84
 2019,Chelan,WA,"Chelan, WA",54288,0,1966,84257,-29969,0.64
 2020,Chelan,WA,"Chelan, WA",59082,9,2322,99514,-40432,0.59
 2021,Chelan,WA,"Chelan, WA",62792,6,3285,140786,-77994,0.45
 2019,Chemung,NY,"Chemung, NY",45402,0,488,20914,24488,2.17
 2020,Chemung,NY,"Chemung, NY",49108,8,528,22629,26479,2.17
 2021,Chemung,NY,"Chemung, NY",52360,7,661,28329,24031,1.85
 2019,Chenango,NY,"Chenango, NY",42909,0,639,27386,15523,1.57
 2020,Chenango,NY,"Chenango, NY",47183,10,633,27129,20054,1.74
 2021,Chenango,NY,"Chenango, NY",50568,7,782,33514,17054,1.51
 2019,Cherokee,AL,"Cherokee, AL",37751,0,1081,46329,-8578,0.81
 2020,Cherokee,AL,"Cherokee, AL",39416,4,1158,49629,-10213,0.79
 2021,Cherokee,AL,"Cherokee, AL",43719,11,1472,63086,-19367,0.69
 2019,Cherokee,GA,"Cherokee, GA",53954,0,1767,75729,-21775,0.71
 2020,Cherokee,GA,"Cherokee, GA",56552,5,1843,78986,-22434,0.72
 2021,Cherokee,GA,"Cherokee, GA",60235,7,2208,94629,-34394,0.64
 2019,Cherokee,IA,"Cherokee, IA",55059,0,379,16243,38816,3.39
 2020,Cherokee,IA,"Cherokee, IA",56063,2,412,17657,38406,3.18
 2021,Cherokee,IA,"Cherokee, IA",61661,10,549,23529,38132,2.62
 2019,Cherokee,KS,"Cherokee, KS",42630,0,314,13457,29173,3.17
 2020,Cherokee,KS,"Cherokee, KS",48048,13,340,14571,33477,3.3
 2021,Cherokee,KS,"Cherokee, KS",51492,7,412,17657,33835,2.92
 2019,Cherokee,NC,"Cherokee, NC",34649,0,949,40671,-6022,0.85
 2020,Cherokee,NC,"Cherokee, NC",37421,8,1022,43800,-6379,0.85
 2021,Cherokee,NC,"Cherokee, NC",40485,8,1508,64629,-24144,0.63
 2019,Cherokee,OK,"Cherokee, OK",35544,0,763,32700,2844,1.09
 2020,Cherokee,OK,"Cherokee, OK",37729,6,839,35957,1772,1.05
 2021,Cherokee,OK,"Cherokee, OK",40638,8,1065,45643,-5005,0.89
 2019,Cherokee,SC,"Cherokee, SC",34346,0,723,30986,3360,1.11
 2020,Cherokee,SC,"Cherokee, SC",37154,8,847,36300,854,1.02
 2021,Cherokee,SC,"Cherokee, SC",40230,8,990,42429,-2199,0.95
 2019,Cherokee,TX,"Cherokee, TX",37366,0,1115,47786,-10420,0.78
 2020,Cherokee,TX,"Cherokee, TX",40202,8,1145,49071,-8869,0.82
 2021,Cherokee,TX,"Cherokee, TX",43376,8,974,41743,1633,1.04
 2019,Cherry,NE,"Cherry, NE",47074,0,1338,57343,-10269,0.82
 2020,Cherry,NE,"Cherry, NE",54140,15,216,9257,44883,5.85
 2021,Cherry,NE,"Cherry, NE",55302,2,731,31329,23973,1.77
 2019,Cheshire,NH,"Cheshire, NH",53260,0,1204,51600,1660,1.03
 2020,Cheshire,NH,"Cheshire, NH",58093,9,1361,58329,-236,1
 2021,Cheshire,NH,"Cheshire, NH",64870,12,1482,63514,1356,1.02
 2019,Chester,PA,"Chester, PA",87486,0,2106,90257,-2771,0.97
 2020,Chester,PA,"Chester, PA",91122,4,2335,100071,-8949,0.91
 2021,Chester,PA,"Chester, PA",95483,5,2475,106071,-10588,0.9
 2019,Chester,SC,"Chester, SC",35924,0,694,29743,6181,1.21
 2020,Chester,SC,"Chester, SC",39521,10,828,35486,4035,1.11
 2021,Chester,SC,"Chester, SC",43169,9,963,41271,1898,1.05
 2019,Chester,TN,"Chester, TN",35315,0,723,30986,4329,1.14
 2020,Chester,TN,"Chester, TN",39057,11,892,38229,828,1.02
 2021,Chester,TN,"Chester, TN",41568,6,1058,45343,-3775,0.92
 2019,Chesterfield,SC,"Chesterfield, SC",34058,0,674,28886,5172,1.18
 2020,Chesterfield,SC,"Chesterfield, SC",36209,6,681,29186,7023,1.24
 2021,Chesterfield,SC,"Chesterfield, SC",39538,9,876,37543,1995,1.05
 2019,Chesterfield,VA,"Chesterfield, VA",54866,0,1689,72386,-17520,0.76
 2020,Chesterfield,VA,"Chesterfield, VA",57829,5,1690,72429,-14600,0.8
 2021,Chesterfield,VA,"Chesterfield, VA",61200,6,1751,75043,-13843,0.82
 2019,Cheyenne,CO,"Cheyenne, CO",54006,0,398,17057,36949,3.17
 2020,Cheyenne,CO,"Cheyenne, CO",47755,-12,197,8443,39312,5.66
 2021,Cheyenne,CO,"Cheyenne, CO",76057,59,1068,45771,30286,1.66
 2019,Cheyenne,KS,"Cheyenne, KS",45782,0,576,24686,21096,1.85
 2020,Cheyenne,KS,"Cheyenne, KS",56260,23,693,29700,26560,1.89
 2021,Cheyenne,KS,"Cheyenne, KS",65154,16,1094,46886,18268,1.39
 2019,Cheyenne,NE,"Cheyenne, NE",48869,0,603,25843,23026,1.89
 2020,Cheyenne,NE,"Cheyenne, NE",51608,6,567,24300,27308,2.12
 2021,Cheyenne,NE,"Cheyenne, NE",52730,2,648,27771,24959,1.9
 2019,Chickasaw,IA,"Chickasaw, IA",55454,0,703,30129,25325,1.84
 2020,Chickasaw,IA,"Chickasaw, IA",58687,6,585,25071,33616,2.34
 2021,Chickasaw,IA,"Chickasaw, IA",64737,10,782,33514,31223,1.93
 2019,Chickasaw,MS,"Chickasaw, MS",36094,0,449,19243,16851,1.88
 2020,Chickasaw,MS,"Chickasaw, MS",39510,10,317,13586,25924,2.91
 2021,Chickasaw,MS,"Chickasaw, MS",41179,4,663,28414,12765,1.45
 2019,Chicot,AR,"Chicot, AR",38030,0,1014,43457,-5427,0.88
 2020,Chicot,AR,"Chicot, AR",44738,18,926,39686,5052,1.13
 2021,Chicot,AR,"Chicot, AR",47402,6,302,12943,34459,3.66
 2019,Childress,TX,"Childress, TX",33254,0,310,13286,19968,2.5
 2020,Childress,TX,"Childress, TX",36264,9,633,27129,9135,1.34
 2021,Childress,TX,"Childress, TX",39953,10,343,14700,25253,2.72
 2019,Chilton,AL,"Chilton, AL",36195,0,878,37629,-1434,0.96
 2020,Chilton,AL,"Chilton, AL",38551,7,1027,44014,-5463,0.88
 2021,Chilton,AL,"Chilton, AL",41748,8,1327,56871,-15123,0.73
 2019,Chippewa,MI,"Chippewa, MI",35733,0,707,30300,5433,1.18
 2020,Chippewa,MI,"Chippewa, MI",40410,13,759,32529,7881,1.24
 2021,Chippewa,MI,"Chippewa, MI",42943,6,916,39257,3686,1.09
 2019,Chippewa,MN,"Chippewa, MN",48039,0,665,28500,19539,1.69
 2020,Chippewa,MN,"Chippewa, MN",52027,8,525,22500,29527,2.31
 2021,Chippewa,MN,"Chippewa, MN",57395,10,809,34671,22724,1.66
 2019,Chippewa,WI,"Chippewa, WI",46990,0,1152,49371,-2381,0.95
 2020,Chippewa,WI,"Chippewa, WI",50185,7,1073,45986,4199,1.09
 2021,Chippewa,WI,"Chippewa, WI",53415,6,1235,52929,486,1.01
 2019,Chisago,MN,"Chisago, MN",51197,0,1518,65057,-13860,0.79
 2020,Chisago,MN,"Chisago, MN",54113,6,1523,65271,-11158,0.83
 2021,Chisago,MN,"Chisago, MN",57574,6,1840,78857,-21283,0.73
 2019,Chittenden,VT,"Chittenden, VT",61686,0,1898,81343,-19657,0.76
 2020,Chittenden,VT,"Chittenden, VT",65123,6,2011,86186,-21063,0.76
 2021,Chittenden,VT,"Chittenden, VT",67921,4,2327,99729,-31808,0.68
 2019,Choctaw,AL,"Choctaw, AL",38651,0,222,9514,29137,4.06
 2020,Choctaw,AL,"Choctaw, AL",41413,7,421,18043,23370,2.3
 2021,Choctaw,AL,"Choctaw, AL",44241,7,1105,47357,-3116,0.93
 2019,Choctaw,MS,"Choctaw, MS",34454,0,542,23229,11225,1.48
 2020,Choctaw,MS,"Choctaw, MS",37992,10,590,25286,12706,1.5
 2021,Choctaw,MS,"Choctaw, MS",40804,7,703,30129,10675,1.35
 2019,Choctaw,OK,"Choctaw, OK",33313,0,719,30814,2499,1.08
 2020,Choctaw,OK,"Choctaw, OK",36804,11,412,17657,19147,2.08
 2021,Choctaw,OK,"Choctaw, OK",40395,10,927,39729,666,1.02
 2019,Chouteau,MT,"Chouteau, MT",39136,0,654,28029,11107,1.4
 2020,Chouteau,MT,"Chouteau, MT",44873,15,862,36943,7930,1.21
 2021,Chouteau,MT,"Chouteau, MT",39287,-12,1230,52714,-13427,0.75
 2019,Chowan,NC,"Chowan, NC",43086,0,1129,48386,-5300,0.89
 2020,Chowan,NC,"Chowan, NC",46206,7,1260,54000,-7794,0.86
 2021,Chowan,NC,"Chowan, NC",50460,9,1345,57643,-7183,0.88
 2019,Christian,IL,"Christian, IL",40055,0,376,16114,23941,2.49
 2020,Christian,IL,"Christian, IL",44393,11,383,16414,27979,2.7
 2021,Christian,IL,"Christian, IL",48831,10,342,14657,34174,3.33
 2019,Christian,KY,"Christian, KY",38150,0,649,27814,10336,1.37
 2020,Christian,KY,"Christian, KY",41809,10,746,31971,9838,1.31
 2021,Christian,KY,"Christian, KY",45643,9,788,33771,11872,1.35
 2019,Christian,MO,"Christian, MO",42877,0,1221,52329,-9452,0.82
 2020,Christian,MO,"Christian, MO",45374,6,1311,56186,-10812,0.81
 2021,Christian,MO,"Christian, MO",48509,7,1762,75514,-27005,0.64
 2019,Churchill,NV,"Churchill, NV",45923,0,1295,55500,-9577,0.83
 2020,Churchill,NV,"Churchill, NV",49871,9,1417,60729,-10858,0.82
 2021,Churchill,NV,"Churchill, NV",54726,10,1770,75857,-21131,0.72
 2019,Cibola,NM,"Cibola, NM",28055,0,500,21429,6626,1.31
 2020,Cibola,NM,"Cibola, NM",31700,13,667,28586,3114,1.11
 2021,Cibola,NM,"Cibola, NM",34627,9,669,28671,5956,1.21
 2019,Citrus,FL,"Citrus, FL",39985,0,1039,44529,-4544,0.9
 2020,Citrus,FL,"Citrus, FL",42292,6,1063,45557,-3265,0.93
 2021,Citrus,FL,"Citrus, FL",45050,7,1399,59957,-14907,0.75
 2019,Clackamas,OR,"Clackamas, OR",62194,0,2644,113314,-51120,0.55
 2020,Clackamas,OR,"Clackamas, OR",66419,7,2531,108471,-42052,0.61
 2021,Clackamas,OR,"Clackamas, OR",71504,8,3238,138771,-67267,0.52
 2019,Claiborne,LA,"Claiborne, LA",37546,0,760,32571,4975,1.15
 2020,Claiborne,LA,"Claiborne, LA",40076,7,667,28586,11490,1.4
 2021,Claiborne,LA,"Claiborne, LA",43953,10,453,19414,24539,2.26
 2019,Claiborne,MS,"Claiborne, MS",31375,0,525,22500,8875,1.39
 2020,Claiborne,MS,"Claiborne, MS",34891,11,658,28200,6691,1.24
 2021,Claiborne,MS,"Claiborne, MS",37833,8,1277,54729,-16896,0.69
 2019,Claiborne,TN,"Claiborne, TN",36464,0,780,33429,3035,1.09
 2020,Claiborne,TN,"Claiborne, TN",39045,7,881,37757,1288,1.03
 2021,Claiborne,TN,"Claiborne, TN",42542,9,1245,53357,-10815,0.8
 2019,Clallam,WA,"Clallam, WA",48024,0,1876,80400,-32376,0.6
 2020,Clallam,WA,"Clallam, WA",51690,8,1998,85629,-33939,0.6
 2021,Clallam,WA,"Clallam, WA",54894,6,2761,118329,-63435,0.46
 2019,Clare,MI,"Clare, MI",34775,0,368,15771,19004,2.2
 2020,Clare,MI,"Clare, MI",38991,12,451,19329,19662,2.02
 2021,Clare,MI,"Clare, MI",40710,4,651,27900,12810,1.46
 2019,Clarendon,SC,"Clarendon, SC",37054,0,1140,48857,-11803,0.76
 2020,Clarendon,SC,"Clarendon, SC",40794,10,1162,49800,-9006,0.82
 2021,Clarendon,SC,"Clarendon, SC",44874,10,1369,58671,-13797,0.76
 2019,Clarion,PA,"Clarion, PA",43226,0,540,23143,20083,1.87
 2020,Clarion,PA,"Clarion, PA",47111,9,506,21686,25425,2.17
 2021,Clarion,PA,"Clarion, PA",49611,5,639,27386,22225,1.81
 2019,Clark,AR,"Clark, AR",38155,0,660,28286,9869,1.35
 2020,Clark,AR,"Clark, AR",41306,8,608,26057,15249,1.59
 2021,Clark,AR,"Clark, AR",42664,3,741,31757,10907,1.34
 2019,Clark,ID,"Clark, ID",44539,0,1126,48257,-3718,0.92
 2020,Clark,ID,"Clark, ID",48687,9,1678,71914,-23227,0.68
 2021,Clark,ID,"Clark, ID",47973,-2,1679,71957,-23984,0.67
 2019,Clark,IL,"Clark, IL",42370,0,441,18900,23470,2.24
 2020,Clark,IL,"Clark, IL",45708,8,418,17914,27794,2.55
 2021,Clark,IL,"Clark, IL",51307,12,586,25114,26193,2.04
 2019,Clark,IN,"Clark, IN",45333,0,1142,48943,-3610,0.93
 2020,Clark,IN,"Clark, IN",48359,7,1121,48043,316,1.01
 2021,Clark,IN,"Clark, IN",51887,7,1324,56743,-4856,0.91
 2019,Clark,KS,"Clark, KS",53878,0,314,13457,40421,4
 2020,Clark,KS,"Clark, KS",58136,8,328,14057,44079,4.14
 2021,Clark,KS,"Clark, KS",59045,2,325,13929,45116,4.24
 2019,Clark,KY,"Clark, KY",40588,0,866,37114,3474,1.09
 2020,Clark,KY,"Clark, KY",44012,8,875,37500,6512,1.17
 2021,Clark,KY,"Clark, KY",47411,8,983,42129,5282,1.13
 2019,Clark,MO,"Clark, MO",36830,0,704,30171,6659,1.22
 2020,Clark,MO,"Clark, MO",40770,11,545,23357,17413,1.75
 2021,Clark,MO,"Clark, MO",43325,6,402,17229,26096,2.51
 2019,Clark,NV,"Clark, NV",51012,0,1500,64286,-13274,0.79
 2020,Clark,NV,"Clark, NV",53562,5,1575,67500,-13938,0.79
 2021,Clark,NV,"Clark, NV",58276,9,2141,91757,-33481,0.64
 2019,Clark,OH,"Clark, OH",41168,0,485,20786,20382,1.98
 2020,Clark,OH,"Clark, OH",44990,9,495,21214,23776,2.12
 2021,Clark,OH,"Clark, OH",47929,7,702,30086,17843,1.59
 2019,Clark,SD,"Clark, SD",47342,0,441,18900,28442,2.5
 2020,Clark,SD,"Clark, SD",69360,47,346,14829,54531,4.68
 2021,Clark,SD,"Clark, SD",71383,3,655,28071,43312,2.54
 2019,Clark,WA,"Clark, WA",55543,0,2160,92571,-37028,0.6
 2020,Clark,WA,"Clark, WA",58629,6,2231,95614,-36985,0.61
 2021,Clark,WA,"Clark, WA",63427,8,2686,115114,-51687,0.55
 2019,Clark,WI,"Clark, WI",43073,0,613,26271,16802,1.64
 2020,Clark,WI,"Clark, WI",47575,11,592,25371,22204,1.88
 2021,Clark,WI,"Clark, WI",50128,5,856,36686,13442,1.37
 2019,Clarke,AL,"Clarke, AL",37426,0,834,35743,1683,1.05
 2020,Clarke,AL,"Clarke, AL",41862,12,729,31243,10619,1.34
 2021,Clarke,AL,"Clarke, AL",45232,8,681,29186,16046,1.55
 2019,Clarke,GA,"Clarke, GA",35408,0,1113,47700,-12292,0.74
 2020,Clarke,GA,"Clarke, GA",38188,8,1187,50871,-12683,0.75
 2021,Clarke,GA,"Clarke, GA",40672,7,1566,67114,-26442,0.61
 2019,Clarke,IA,"Clarke, IA",39227,0,552,23657,15570,1.66
 2020,Clarke,IA,"Clarke, IA",42923,9,655,28071,14852,1.53
 2021,Clarke,IA,"Clarke, IA",45292,6,604,25886,19406,1.75
 2019,Clarke,MS,"Clarke, MS",38328,0,690,29571,8757,1.3
 2020,Clarke,MS,"Clarke, MS",41601,9,587,25157,16444,1.65
 2021,Clarke,MS,"Clarke, MS",43918,6,556,23829,20089,1.84
 2019,Clarke,VA,"Clarke, VA",68329,0,2017,86443,-18114,0.79
 2020,Clarke,VA,"Clarke, VA",71331,4,2030,87000,-15669,0.82
 2021,Clarke,VA,"Clarke, VA",75403,6,3285,140786,-65383,0.54
 2019,Clatsop,OR,"Clatsop, OR",45253,0,2059,88243,-42990,0.51
 2020,Clatsop,OR,"Clatsop, OR",49063,8,2090,89571,-40508,0.55
 2021,Clatsop,OR,"Clatsop, OR",52250,7,2801,120043,-67793,0.44
 2019,Clay,AL,"Clay, AL",32059,0,746,31971,88,1
 2020,Clay,AL,"Clay, AL",34660,8,719,30814,3846,1.12
 2021,Clay,AL,"Clay, AL",38705,12,1062,45514,-6809,0.85
 2019,Clay,AR,"Clay, AR",34905,0,258,11057,23848,3.16
 2020,Clay,AR,"Clay, AR",39772,14,329,14100,25672,2.82
 2021,Clay,AR,"Clay, AR",42999,8,438,18771,24228,2.29
 2019,Clay,FL,"Clay, FL",45319,0,1267,54300,-8981,0.83
 2020,Clay,FL,"Clay, FL",48070,6,1265,54214,-6144,0.89
 2021,Clay,FL,"Clay, FL",51885,8,1699,72814,-20929,0.71
 2019,Clay,GA,"Clay, GA",33969,0,1100,47143,-13174,0.72
 2020,Clay,GA,"Clay, GA",38731,14,1290,55286,-16555,0.7
 2021,Clay,GA,"Clay, GA",40439,4,2359,101100,-60661,0.4
 2019,Clay,IA,"Clay, IA",50798,0,720,30857,19941,1.65
 2020,Clay,IA,"Clay, IA",54344,7,737,31586,22758,1.72
 2021,Clay,IA,"Clay, IA",59187,9,735,31500,27687,1.88
 2019,Clay,IL,"Clay, IL",39303,0,404,17314,21989,2.27
 2020,Clay,IL,"Clay, IL",43835,12,395,16929,26906,2.59
 2021,Clay,IL,"Clay, IL",49656,13,468,20057,29599,2.48
 2019,Clay,IN,"Clay, IN",37716,0,490,21000,16716,1.8
 2020,Clay,IN,"Clay, IN",41155,9,437,18729,22426,2.2
 2021,Clay,IN,"Clay, IN",44878,9,537,23014,21864,1.95
 2019,Clay,KS,"Clay, KS",43108,0,516,22114,20994,1.95
 2020,Clay,KS,"Clay, KS",47886,11,558,23914,23972,2
 2021,Clay,KS,"Clay, KS",50592,6,659,28243,22349,1.79
 2019,Clay,KY,"Clay, KY",29956,0,608,26057,3899,1.15
 2020,Clay,KY,"Clay, KY",34389,15,538,23057,11332,1.49
 2021,Clay,KY,"Clay, KY",39099,14,891,38186,913,1.02
 2019,Clay,MN,"Clay, MN",43312,0,1123,48129,-4817,0.9
 2020,Clay,MN,"Clay, MN",47440,10,1151,49329,-1889,0.96
 2021,Clay,MN,"Clay, MN",51260,8,1334,57171,-5911,0.9
 2019,Clay,MO,"Clay, MO",49328,0,1432,61371,-12043,0.8
 2020,Clay,MO,"Clay, MO",52450,6,1550,66429,-13979,0.79
 2021,Clay,MO,"Clay, MO",56118,7,1752,75086,-18968,0.75
 2019,Clay,MS,"Clay, MS",39833,0,578,24771,15062,1.61
 2020,Clay,MS,"Clay, MS",43638,10,611,26186,17452,1.67
 2021,Clay,MS,"Clay, MS",46228,6,726,31114,15114,1.49
 2019,Clay,NC,"Clay, NC",37286,0,1309,56100,-18814,0.66
 2020,Clay,NC,"Clay, NC",40229,8,1444,61886,-21657,0.65
 2021,Clay,NC,"Clay, NC",43300,8,1873,80271,-36971,0.54
 2019,Clay,NE,"Clay, NE",52353,0,639,27386,24967,1.91
 2020,Clay,NE,"Clay, NE",58528,12,561,24043,34485,2.43
 2021,Clay,NE,"Clay, NE",63915,9,628,26914,37001,2.37
 2019,Clay,SD,"Clay, SD",39918,0,1217,52157,-12239,0.77
 2020,Clay,SD,"Clay, SD",42439,6,730,31286,11153,1.36
 2021,Clay,SD,"Clay, SD",47288,11,1053,45129,2159,1.05
 2019,Clay,TN,"Clay, TN",32550,0,1001,42900,-10350,0.76
 2020,Clay,TN,"Clay, TN",34540,6,974,41743,-7203,0.83
 2021,Clay,TN,"Clay, TN",40338,17,1072,45943,-5605,0.88
 2019,Clay,TX,"Clay, TX",46704,0,477,20443,26261,2.28
 2020,Clay,TX,"Clay, TX",49170,5,694,29743,19427,1.65
 2021,Clay,TX,"Clay, TX",51938,6,965,41357,10581,1.26
 2019,Clay,WV,"Clay, WV",33901,0,633,27129,6772,1.25
 2020,Clay,WV,"Clay, WV",36743,8,568,24343,12400,1.51
 2021,Clay,WV,"Clay, WV",39788,8,398,17057,22731,2.33
 2019,Clayton,GA,"Clayton, GA",28280,0,746,31971,-3691,0.88
 2020,Clayton,GA,"Clayton, GA",32446,15,827,35443,-2997,0.92
 2021,Clayton,GA,"Clayton, GA",36056,11,1110,47571,-11515,0.76
 2019,Clayton,IA,"Clayton, IA",51664,0,648,27771,23893,1.86
 2020,Clayton,IA,"Clayton, IA",55732,8,630,27000,28732,2.06
 2021,Clayton,IA,"Clayton, IA",59656,7,1068,45771,13885,1.3
 2019,Clear Creek,CO,"Clear Creek, CO",66439,0,1961,84043,-17604,0.79
 2020,Clear Creek,CO,"Clear Creek, CO",70828,7,2977,127586,-56758,0.56
 2021,Clear Creek,CO,"Clear Creek, CO",77242,9,4377,187586,-110344,0.41
 2019,Clearfield,PA,"Clearfield, PA",45050,0,496,21257,23793,2.12
 2020,Clearfield,PA,"Clearfield, PA",49517,10,565,24214,25303,2.04
 2021,Clearfield,PA,"Clearfield, PA",52478,6,642,27514,24964,1.91
 2019,Clearwater,ID,"Clearwater, ID",36261,0,731,31329,4932,1.16
 2020,Clearwater,ID,"Clearwater, ID",39465,9,1010,43286,-3821,0.91
 2021,Clearwater,ID,"Clearwater, ID",41834,6,1047,44871,-3037,0.93
 2019,Clearwater,MN,"Clearwater, MN",46005,0,837,35871,10134,1.28
 2020,Clearwater,MN,"Clearwater, MN",51893,13,803,34414,17479,1.51
 2021,Clearwater,MN,"Clearwater, MN",54687,5,756,32400,22287,1.69
 2019,Cleburne,AL,"Cleburne, AL",35819,0,840,36000,-181,0.99
 2020,Cleburne,AL,"Cleburne, AL",37670,5,905,38786,-1116,0.97
 2021,Cleburne,AL,"Cleburne, AL",42836,14,1207,51729,-8893,0.83
 2019,Cleburne,AR,"Cleburne, AR",39597,0,1057,45300,-5703,0.87
 2020,Cleburne,AR,"Cleburne, AR",42579,8,1076,46114,-3535,0.92
 2021,Cleburne,AR,"Cleburne, AR",45289,6,1959,83957,-38668,0.54
 2019,Clermont,OH,"Clermont, OH",57898,0,1290,55286,2612,1.05
 2020,Clermont,OH,"Clermont, OH",61442,6,1365,58500,2942,1.05
 2021,Clermont,OH,"Clermont, OH",64895,6,1509,64671,224,1
 2019,Clinch,GA,"Clinch, GA",37877,0,585,25071,12806,1.51
 2020,Clinch,GA,"Clinch, GA",40601,7,560,24000,16601,1.69
 2021,Clinch,GA,"Clinch, GA",42450,5,411,17614,24836,2.41
 2019,Clinton,IA,"Clinton, IA",45194,0,436,18686,26508,2.42
 2020,Clinton,IA,"Clinton, IA",48420,7,368,15771,32649,3.07
 2021,Clinton,IA,"Clinton, IA",52308,8,556,23829,28479,2.2
 2019,Clinton,IL,"Clinton, IL",49198,0,618,26486,22712,1.86
 2020,Clinton,IL,"Clinton, IL",52677,7,706,30257,22420,1.74
 2021,Clinton,IL,"Clinton, IL",56536,7,757,32443,24093,1.74
 2019,Clinton,IN,"Clinton, IN",38411,0,658,28200,10211,1.36
 2020,Clinton,IN,"Clinton, IN",41545,8,451,19329,22216,2.15
 2021,Clinton,IN,"Clinton, IN",45305,9,775,33214,12091,1.36
 2019,Clinton,KY,"Clinton, KY",34470,0,402,17229,17241,2
 2020,Clinton,KY,"Clinton, KY",39474,15,490,21000,18474,1.88
 2021,Clinton,KY,"Clinton, KY",44613,13,1303,55843,-11230,0.8
 2019,Clinton,MI,"Clinton, MI",48051,0,1198,51343,-3292,0.94
 2020,Clinton,MI,"Clinton, MI",51861,8,1309,56100,-4239,0.92
 2021,Clinton,MI,"Clinton, MI",54719,6,1382,59229,-4510,0.92
 2019,Clinton,MO,"Clinton, MO",42840,0,910,39000,3840,1.1
 2020,Clinton,MO,"Clinton, MO",46082,8,1112,47657,-1575,0.97
 2021,Clinton,MO,"Clinton, MO",48730,6,869,37243,11487,1.31
 2019,Clinton,NY,"Clinton, NY",44979,0,767,32871,12108,1.37
 2020,Clinton,NY,"Clinton, NY",48408,8,804,34457,13951,1.4
 2021,Clinton,NY,"Clinton, NY",50625,5,934,40029,10596,1.26
 2019,Clinton,OH,"Clinton, OH",45799,0,636,27257,18542,1.68
 2020,Clinton,OH,"Clinton, OH",48335,6,655,28071,20264,1.72
 2021,Clinton,OH,"Clinton, OH",52090,8,914,39171,12919,1.33
 2019,Clinton,PA,"Clinton, PA",43321,0,655,28071,15250,1.54
 2020,Clinton,PA,"Clinton, PA",47075,9,628,26914,20161,1.75
 2021,Clinton,PA,"Clinton, PA",49312,5,784,33600,15712,1.47
 2019,Cloud,KS,"Cloud, KS",38962,0,263,11271,27691,3.46
 2020,Cloud,KS,"Cloud, KS",44057,13,780,33429,10628,1.32
 2021,Cloud,KS,"Cloud, KS",47195,7,257,11014,36181,4.29
 2019,Coahoma,MS,"Coahoma, MS",37003,0,620,26571,10432,1.39
 2020,Coahoma,MS,"Coahoma, MS",41488,12,485,20786,20702,2
 2021,Coahoma,MS,"Coahoma, MS",44714,8,375,16071,28643,2.78
 2019,Coal,OK,"Coal, OK",40247,0,403,17271,22976,2.33
 2020,Coal,OK,"Coal, OK",40718,1,437,18729,21989,2.17
 2021,Coal,OK,"Coal, OK",44170,9,375,16071,28099,2.75
 2019,Cobb,GA,"Cobb, GA",60261,0,1756,75257,-14996,0.8
 2020,Cobb,GA,"Cobb, GA",63105,5,1802,77229,-14124,0.82
 2021,Cobb,GA,"Cobb, GA",67616,7,2001,85757,-18141,0.79
 2019,Cochise,AZ,"Cochise, AZ",41557,0,908,38914,2643,1.07
 2020,Cochise,AZ,"Cochise, AZ",46909,13,964,41314,5595,1.14
 2021,Cochise,AZ,"Cochise, AZ",49096,5,1373,58843,-9747,0.83
 2019,Cochran,TX,"Cochran, TX",41365,0,250,10714,30651,3.86
 2020,Cochran,TX,"Cochran, TX",46391,12,323,13843,32548,3.35
 2021,Cochran,TX,"Cochran, TX",62305,34,412,17657,44648,3.53
 2019,Cocke,TN,"Cocke, TN",33984,0,867,37157,-3173,0.91
 2020,Cocke,TN,"Cocke, TN",37322,10,1089,46671,-9349,0.8
 2021,Cocke,TN,"Cocke, TN",40384,8,1251,53614,-13230,0.75
 2019,Coconino,AZ,"Coconino, AZ",49454,0,2194,94029,-44575,0.53
 2020,Coconino,AZ,"Coconino, AZ",54008,9,2436,104400,-50392,0.52
 2021,Coconino,AZ,"Coconino, AZ",56914,5,3161,135471,-78557,0.42
 2019,Codington,SD,"Codington, SD",51821,0,1090,46714,5107,1.11
 2020,Codington,SD,"Codington, SD",56540,9,1088,46629,9911,1.21
 2021,Codington,SD,"Codington, SD",59387,5,1630,69857,-10470,0.85
 2019,Coffee,AL,"Coffee, AL",43164,0,856,36686,6478,1.18
 2020,Coffee,AL,"Coffee, AL",45466,5,836,35829,9637,1.27
 2021,Coffee,AL,"Coffee, AL",49196,8,931,39900,9296,1.23
 2019,Coffee,GA,"Coffee, GA",32872,0,724,31029,1843,1.06
 2020,Coffee,GA,"Coffee, GA",35690,9,678,29057,6633,1.23
 2021,Coffee,GA,"Coffee, GA",40209,13,1062,45514,-5305,0.88
 2019,Coffee,TN,"Coffee, TN",41181,0,1185,50786,-9605,0.81
 2020,Coffee,TN,"Coffee, TN",43805,6,1145,49071,-5266,0.89
 2021,Coffee,TN,"Coffee, TN",46299,6,1733,74271,-27972,0.62
 2019,Coffey,KS,"Coffey, KS",51433,0,595,25500,25933,2.02
 2020,Coffey,KS,"Coffey, KS",56637,10,515,22071,34566,2.57
 2021,Coffey,KS,"Coffey, KS",58867,4,639,27386,31481,2.15
 2019,Coke,TX,"Coke, TX",43459,0,467,20014,23445,2.17
 2020,Coke,TX,"Coke, TX",46405,7,573,24557,21848,1.89
 2021,Coke,TX,"Coke, TX",48804,5,873,37414,11390,1.3
 2019,Colbert,AL,"Colbert, AL",37912,0,792,33943,3969,1.12
 2020,Colbert,AL,"Colbert, AL",41088,8,889,38100,2988,1.08
 2021,Colbert,AL,"Colbert, AL",44279,8,858,36771,7508,1.2
 2019,Cole,MO,"Cole, MO",48294,0,834,35743,12551,1.35
 2020,Cole,MO,"Cole, MO",52134,8,923,39557,12577,1.32
 2021,Cole,MO,"Cole, MO",54941,5,953,40843,14098,1.35
 2019,Coleman,TX,"Coleman, TX",46813,0,337,14443,32370,3.24
 2020,Coleman,TX,"Coleman, TX",50458,8,346,14829,35629,3.4
 2021,Coleman,TX,"Coleman, TX",54822,9,362,15514,39308,3.53
 2019,Coles,IL,"Coles, IL",44884,0,404,17314,27570,2.59
 2020,Coles,IL,"Coles, IL",49333,10,442,18943,30390,2.6
 2021,Coles,IL,"Coles, IL",53596,9,400,17143,36453,3.13
 2019,Colfax,NE,"Colfax, NE",44150,0,726,31114,13036,1.42
 2020,Colfax,NE,"Colfax, NE",50636,15,919,39386,11250,1.29
 2021,Colfax,NE,"Colfax, NE",54392,7,828,35486,18906,1.53
 2019,Colfax,NM,"Colfax, NM",40240,0,1207,51729,-11489,0.78
 2020,Colfax,NM,"Colfax, NM",44671,11,1445,61929,-17258,0.72
 2021,Colfax,NM,"Colfax, NM",47563,7,1863,79843,-32280,0.6
 2019,Colleton,SC,"Colleton, SC",36296,0,1405,60214,-23918,0.6
 2020,Colleton,SC,"Colleton, SC",39240,8,1484,63600,-24360,0.62
 2021,Colleton,SC,"Colleton, SC",42481,8,1555,66643,-24162,0.64
 2019,Collier,FL,"Collier, FL",110272,0,2180,93429,16843,1.18
 2020,Collier,FL,"Collier, FL",112479,2,2278,97629,14850,1.15
 2021,Collier,FL,"Collier, FL",117984,5,3472,148800,-30816,0.79
 2019,Collin,TX,"Collin, TX",70813,0,1920,82286,-11473,0.86
 2020,Collin,TX,"Collin, TX",72218,2,1897,81300,-9082,0.89
 2021,Collin,TX,"Collin, TX",77006,7,2316,99257,-22251,0.78
 2019,Collingsworth,TX,"Collingsworth, TX",44388,0,405,17357,27031,2.56
 2020,Collingsworth,TX,"Collingsworth, TX",47999,8,492,21086,26913,2.28
 2021,Collingsworth,TX,"Collingsworth, TX",54140,13,883,37843,16297,1.43
 2019,Colorado,TX,"Colorado, TX",51419,0,1083,46414,5005,1.11
 2020,Colorado,TX,"Colorado, TX",54702,6,1148,49200,5502,1.11
 2021,Colorado,TX,"Colorado, TX",59219,8,1211,51900,7319,1.14
 2019,Colquitt,GA,"Colquitt, GA",33677,0,758,32486,1191,1.04
 2020,Colquitt,GA,"Colquitt, GA",37233,11,913,39129,-1896,0.95
 2021,Colquitt,GA,"Colquitt, GA",40678,9,1096,46971,-6293,0.87
 2019,Columbia,AR,"Columbia, AR",38169,0,707,30300,7869,1.26
 2020,Columbia,AR,"Columbia, AR",40526,6,715,30643,9883,1.32
 2021,Columbia,AR,"Columbia, AR",42785,6,827,35443,7342,1.21
 2019,Columbia,FL,"Columbia, FL",37206,0,973,41700,-4494,0.89
 2020,Columbia,FL,"Columbia, FL",39839,7,1078,46200,-6361,0.86
 2021,Columbia,FL,"Columbia, FL",43184,8,1267,54300,-11116,0.8
 2019,Columbia,GA,"Columbia, GA",53105,0,1281,54900,-1795,0.97
 2020,Columbia,GA,"Columbia, GA",55920,5,1373,58843,-2923,0.95
 2021,Columbia,GA,"Columbia, GA",58242,4,1741,74614,-16372,0.78
 2019,Columbia,NY,"Columbia, NY",57978,0,1817,77871,-19893,0.74
 2020,Columbia,NY,"Columbia, NY",61949,7,1946,83400,-21451,0.74
 2021,Columbia,NY,"Columbia, NY",65426,6,2371,101614,-36188,0.64
 2019,Columbia,OR,"Columbia, OR",45762,0,1672,71657,-25895,0.64
 2020,Columbia,OR,"Columbia, OR",49273,8,1842,78943,-29670,0.62
 2021,Columbia,OR,"Columbia, OR",53573,9,2130,91286,-37713,0.59
 2019,Columbia,PA,"Columbia, PA",43624,0,744,31886,11738,1.37
 2020,Columbia,PA,"Columbia, PA",47565,9,743,31843,15722,1.49
 2021,Columbia,PA,"Columbia, PA",50176,6,822,35229,14947,1.42
 2019,Columbia,WA,"Columbia, WA",57520,0,970,41571,15949,1.38
 2020,Columbia,WA,"Columbia, WA",65425,14,877,37586,27839,1.74
 2021,Columbia,WA,"Columbia, WA",70579,8,2218,95057,-24478,0.74
 2019,Columbia,WI,"Columbia, WI",52934,0,1294,55457,-2523,0.95
 2020,Columbia,WI,"Columbia, WI",56566,7,1374,58886,-2320,0.96
 2021,Columbia,WI,"Columbia, WI",60708,7,1449,62100,-1392,0.98
 2019,Columbiana,OH,"Columbiana, OH",39393,0,578,24771,14622,1.59
 2020,Columbiana,OH,"Columbiana, OH",42931,9,492,21086,21845,2.04
 2021,Columbiana,OH,"Columbiana, OH",45580,6,536,22971,22609,1.98
 2019,Columbus,NC,"Columbus, NC",36093,0,749,32100,3993,1.12
 2020,Columbus,NC,"Columbus, NC",40202,11,843,36129,4073,1.11
 2021,Columbus,NC,"Columbus, NC",44729,11,1000,42857,1872,1.04
 2019,Colusa,CA,"Colusa, CA",45180,0,1705,73071,-27891,0.62
 2020,Colusa,CA,"Colusa, CA",55498,23,1729,74100,-18602,0.75
 2021,Colusa,CA,"Colusa, CA",54511,-2,2165,92786,-38275,0.59
 2019,Comal,TX,"Comal, TX",63236,0,1740,74571,-11335,0.85
 2020,Comal,TX,"Comal, TX",64164,2,1781,76329,-12165,0.84
 2021,Comal,TX,"Comal, TX",67063,5,2587,110871,-43808,0.6
 2019,Comanche,KS,"Comanche, KS",41773,0,408,17486,24287,2.39
 2020,Comanche,KS,"Comanche, KS",48194,15,528,22629,25565,2.13
 2021,Comanche,KS,"Comanche, KS",54928,14,499,21386,33542,2.57
 2019,Comanche,OK,"Comanche, OK",42511,0,568,24343,18168,1.75
 2020,Comanche,OK,"Comanche, OK",45353,7,585,25071,20282,1.81
 2021,Comanche,OK,"Comanche, OK",47650,5,520,22286,25364,2.14
 2019,Comanche,TX,"Comanche, TX",44216,0,624,26743,17473,1.65
 2020,Comanche,TX,"Comanche, TX",47532,8,601,25757,21775,1.85
 2021,Comanche,TX,"Comanche, TX",50112,5,877,37586,12526,1.33
 2019,Concho,TX,"Concho, TX",31497,0,472,20229,11268,1.56
 2020,Concho,TX,"Concho, TX",34970,11,1273,54557,-19587,0.64
 2021,Concho,TX,"Concho, TX",38635,11,862,36943,1692,1.05
 2019,Concordia,LA,"Concordia, LA",34181,0,673,28843,5338,1.19
 2020,Concordia,LA,"Concordia, LA",39748,16,846,36257,3491,1.1
 2021,Concordia,LA,"Concordia, LA",43299,9,781,33471,9828,1.29
 2019,Conecuh,AL,"Conecuh, AL",34183,0,727,31157,3026,1.1
 2020,Conecuh,AL,"Conecuh, AL",37887,11,355,15214,22673,2.49
 2021,Conecuh,AL,"Conecuh, AL",41656,10,528,22629,19027,1.84
 2019,Conejos,CO,"Conejos, CO",38179,0,1037,44443,-6264,0.86
 2020,Conejos,CO,"Conejos, CO",41346,8,1463,62700,-21354,0.66
 2021,Conejos,CO,"Conejos, CO",45961,11,1275,54643,-8682,0.84
 2019,Contra Costa,CA,"Contra Costa, CA",81782,0,3059,131100,-49318,0.62
 2020,Contra Costa,CA,"Contra Costa, CA",88910,9,3163,135557,-46647,0.66
 2021,Contra Costa,CA,"Contra Costa, CA",99312,12,3670,157286,-57974,0.63
 2019,Converse,WY,"Converse, WY",69603,0,1108,47486,22117,1.47
 2020,Converse,WY,"Converse, WY",68246,-2,1098,47057,21189,1.45
 2021,Converse,WY,"Converse, WY",69583,2,1104,47314,22269,1.47
 2019,Conway,AR,"Conway, AR",38985,0,641,27471,11514,1.42
 2020,Conway,AR,"Conway, AR",41696,7,615,26357,15339,1.58
 2021,Conway,AR,"Conway, AR",46412,11,779,33386,13026,1.39
 2019,Cook,GA,"Cook, GA",33537,0,648,27771,5766,1.21
 2020,Cook,GA,"Cook, GA",36344,8,494,21171,15173,1.72
 2021,Cook,GA,"Cook, GA",39380,8,622,26657,12723,1.48
 2019,Cook,IL,"Cook, IL",63971,0,1463,62700,1271,1.02
 2020,Cook,IL,"Cook, IL",67558,6,1482,63514,4044,1.06
 2021,Cook,IL,"Cook, IL",73557,9,1497,64157,9400,1.15
 2019,Cook,MN,"Cook, MN",53157,0,1043,44700,8457,1.19
 2020,Cook,MN,"Cook, MN",56400,6,1351,57900,-1500,0.97
 2021,Cook,MN,"Cook, MN",59112,5,1811,77614,-18502,0.76
 2019,Cooke,TX,"Cooke, TX",53372,0,1268,54343,-971,0.98
 2020,Cooke,TX,"Cooke, TX",55863,5,1392,59657,-3794,0.94
 2021,Cooke,TX,"Cooke, TX",59800,7,1390,59571,229,1
 2019,Cooper,MO,"Cooper, MO",39949,0,687,29443,10506,1.36
 2020,Cooper,MO,"Cooper, MO",44416,11,723,30986,13430,1.43
 2021,Cooper,MO,"Cooper, MO",47383,7,675,28929,18454,1.64
 2019,Coos,NH,"Coos, NH",45254,0,711,30471,14783,1.49
 2020,Coos,NH,"Coos, NH",49535,10,734,31457,18078,1.57
 2021,Coos,NH,"Coos, NH",52132,5,969,41529,10603,1.26
 2019,Coos,OR,"Coos, OR",46736,0,1325,56786,-10050,0.82
 2020,Coos,OR,"Coos, OR",51557,10,1535,65786,-14229,0.78
 2021,Coos,OR,"Coos, OR",55759,8,1751,75043,-19284,0.74
 2019,Coosa,AL,"Coosa, AL",33311,0,1313,56271,-22960,0.59
 2020,Coosa,AL,"Coosa, AL",35542,7,1062,45514,-9972,0.78
 2021,Coosa,AL,"Coosa, AL",38275,8,1621,69471,-31196,0.55
 2019,Copiah,MS,"Copiah, MS",33613,0,753,32271,1342,1.04
 2020,Copiah,MS,"Copiah, MS",36223,8,767,32871,3352,1.1
 2021,Copiah,MS,"Copiah, MS",39166,8,859,36814,2352,1.06
 2019,Corson,SD,"Corson, SD",27953,0,71,3043,24910,9.19
 2020,Corson,SD,"Corson, SD",31967,14,149,6386,25581,5.01
 2019,Coryell,TX,"Coryell, TX",32816,0,868,37200,-4384,0.88
 2020,Coryell,TX,"Coryell, TX",35113,7,849,36386,-1273,0.97
 2021,Coryell,TX,"Coryell, TX",37476,7,1001,42900,-5424,0.87
 2019,Coshocton,OH,"Coshocton, OH",36206,0,489,20957,15249,1.73
 2020,Coshocton,OH,"Coshocton, OH",39883,10,553,23700,16183,1.68
 2021,Coshocton,OH,"Coshocton, OH",42403,6,689,29529,12874,1.44
 2019,Costilla,CO,"Costilla, CO",37326,0,820,35143,2183,1.06
 2020,Costilla,CO,"Costilla, CO",39705,6,1054,45171,-5466,0.88
 2021,Costilla,CO,"Costilla, CO",43239,9,1003,42986,253,1.01
 2019,Cottle,TX,"Cottle, TX",53393,0,325,13929,39464,3.83
 2020,Cottle,TX,"Cottle, TX",61049,14,422,18086,42963,3.38
 2021,Cottle,TX,"Cottle, TX",73613,21,359,15386,58227,4.78
 2019,Cotton,OK,"Cotton, OK",45057,0,592,25371,19686,1.78
 2020,Cotton,OK,"Cotton, OK",49068,9,327,14014,35054,3.5
 2021,Cotton,OK,"Cotton, OK",51300,5,662,28371,22929,1.81
 2019,Cottonwood,MN,"Cottonwood, MN",44993,0,489,20957,24036,2.15
 2020,Cottonwood,MN,"Cottonwood, MN",54800,22,560,24000,30800,2.28
 2021,Cottonwood,MN,"Cottonwood, MN",58229,6,809,34671,23558,1.68
 2019,Covington,AL,"Covington, AL",35472,0,721,30900,4572,1.15
 2020,Covington,AL,"Covington, AL",37777,7,659,28243,9534,1.34
 2021,Covington,AL,"Covington, AL",41458,10,766,32829,8629,1.26
 2019,Covington,MS,"Covington, MS",38557,0,717,30729,7828,1.25
 2020,Covington,MS,"Covington, MS",39134,2,876,37543,1591,1.04
 2021,Covington,MS,"Covington, MS",45169,15,804,34457,10712,1.31
 2019,Coweta,GA,"Coweta, GA",50529,0,1584,67886,-17357,0.74
 2020,Coweta,GA,"Coweta, GA",53894,7,1704,73029,-19135,0.74
 2021,Coweta,GA,"Coweta, GA",57721,7,1956,83829,-26108,0.69
 2019,Cowley,KS,"Cowley, KS",39547,0,399,17100,22447,2.31
 2020,Cowley,KS,"Cowley, KS",42623,8,395,16929,25694,2.52
 2021,Cowley,KS,"Cowley, KS",44888,5,592,25371,19517,1.77
 2019,Cowlitz,WA,"Cowlitz, WA",46108,0,1550,66429,-20321,0.69
 2020,Cowlitz,WA,"Cowlitz, WA",49882,8,1517,65014,-15132,0.77
 2021,Cowlitz,WA,"Cowlitz, WA",54550,9,2010,86143,-31593,0.63
 2019,Craig,OK,"Craig, OK",39611,0,576,24686,14925,1.6
 2020,Craig,OK,"Craig, OK",41011,4,569,24386,16625,1.68
 2021,Craig,OK,"Craig, OK",43958,7,809,34671,9287,1.27
 2019,Craig,VA,"Craig, VA",40988,0,763,32700,8288,1.25
 2020,Craig,VA,"Craig, VA",43959,7,1146,49114,-5155,0.9
 2021,Craig,VA,"Craig, VA",47457,8,1157,49586,-2129,0.96
 2019,Craighead,AR,"Craighead, AR",38810,0,962,41229,-2419,0.94
 2020,Craighead,AR,"Craighead, AR",42024,8,983,42129,-105,1
 2021,Craighead,AR,"Craighead, AR",45160,8,1158,49629,-4469,0.91
 2019,Crane,TX,"Crane, TX",54198,0,783,33557,20641,1.62
 2020,Crane,TX,"Crane, TX",49986,-8,860,36857,13129,1.36
 2021,Crane,TX,"Crane, TX",54119,8,1023,43843,10276,1.23
 2019,Craven,NC,"Craven, NC",46534,0,1050,45000,1534,1.03
 2020,Craven,NC,"Craven, NC",50408,8,1075,46071,4337,1.09
 2021,Craven,NC,"Craven, NC",54135,7,1414,60600,-6465,0.89
 2019,Crawford,AR,"Crawford, AR",35445,0,739,31671,3774,1.12
 2020,Crawford,AR,"Crawford, AR",37829,7,793,33986,3843,1.11
 2021,Crawford,AR,"Crawford, AR",40691,8,1182,50657,-9966,0.8
 2019,Crawford,GA,"Crawford, GA",35090,0,684,29314,5776,1.2
 2020,Crawford,GA,"Crawford, GA",37733,8,603,25843,11890,1.46
 2021,Crawford,GA,"Crawford, GA",41063,9,1317,56443,-15380,0.73
 2019,Crawford,IA,"Crawford, IA",43143,0,525,22500,20643,1.92
 2020,Crawford,IA,"Crawford, IA",45659,6,560,24000,21659,1.9
 2021,Crawford,IA,"Crawford, IA",51690,13,631,27043,24647,1.91
 2019,Crawford,IL,"Crawford, IL",46454,0,469,20100,26354,2.31
 2020,Crawford,IL,"Crawford, IL",49604,7,534,22886,26718,2.17
 2021,Crawford,IL,"Crawford, IL",52318,6,474,20314,32004,2.58
 2019,Crawford,IN,"Crawford, IN",35150,0,514,22029,13121,1.6
 2020,Crawford,IN,"Crawford, IN",38485,10,664,28457,10028,1.35
 2021,Crawford,IN,"Crawford, IN",41854,9,869,37243,4611,1.12
 2019,Crawford,KS,"Crawford, KS",39049,0,359,15386,23663,2.54
 2020,Crawford,KS,"Crawford, KS",42668,9,385,16500,26168,2.59
 2021,Crawford,KS,"Crawford, KS",45046,6,455,19500,25546,2.31
 2019,Crawford,MI,"Crawford, MI",37722,0,658,28200,9522,1.34
 2020,Crawford,MI,"Crawford, MI",42782,13,754,32314,10468,1.32
 2021,Crawford,MI,"Crawford, MI",44116,3,828,35486,8630,1.24
 2019,Crawford,MO,"Crawford, MO",37178,0,760,32571,4607,1.14
 2020,Crawford,MO,"Crawford, MO",40033,8,747,32014,8019,1.25
 2021,Crawford,MO,"Crawford, MO",43192,8,690,29571,13621,1.46
 2019,Crawford,OH,"Crawford, OH",38215,0,385,16500,21715,2.32
 2020,Crawford,OH,"Crawford, OH",42508,11,408,17486,25022,2.43
 2021,Crawford,OH,"Crawford, OH",45755,8,638,27343,18412,1.67
 2019,Crawford,PA,"Crawford, PA",41976,0,597,25586,16390,1.64
 2020,Crawford,PA,"Crawford, PA",45838,9,610,26143,19695,1.75
 2021,Crawford,PA,"Crawford, PA",48431,6,687,29443,18988,1.64
 2019,Crawford,WI,"Crawford, WI",43205,0,854,36600,6605,1.18
 2020,Crawford,WI,"Crawford, WI",46612,8,680,29143,17469,1.6
 2021,Crawford,WI,"Crawford, WI",49273,6,910,39000,10273,1.26
 2019,Creek,OK,"Creek, OK",42775,0,754,32314,10461,1.32
 2020,Creek,OK,"Creek, OK",45323,6,764,32743,12580,1.38
 2021,Creek,OK,"Creek, OK",47927,6,884,37886,10041,1.27
 2019,Crenshaw,AL,"Crenshaw, AL",37965,0,489,20957,17008,1.81
 2020,Crenshaw,AL,"Crenshaw, AL",39921,5,535,22929,16992,1.74
 2021,Crenshaw,AL,"Crenshaw, AL",46038,15,1029,44100,1938,1.04
 2019,Crisp,GA,"Crisp, GA",37640,0,1073,45986,-8346,0.82
 2020,Crisp,GA,"Crisp, GA",41308,10,1007,43157,-1849,0.96
 2021,Crisp,GA,"Crisp, GA",45951,11,1063,45557,394,1.01
 2019,Crittenden,AR,"Crittenden, AR",37978,0,639,27386,10592,1.39
 2020,Crittenden,AR,"Crittenden, AR",41598,10,648,27771,13827,1.5
 2021,Crittenden,AR,"Crittenden, AR",45416,9,781,33471,11945,1.36
 2019,Crittenden,KY,"Crittenden, KY",36023,0,459,19671,16352,1.83
 2020,Crittenden,KY,"Crittenden, KY",39704,10,707,30300,9404,1.31
 2021,Crittenden,KY,"Crittenden, KY",43616,10,435,18643,24973,2.34
 2019,Crockett,TN,"Crockett, TN",42303,0,513,21986,20317,1.92
 2020,Crockett,TN,"Crockett, TN",44625,6,593,25414,19211,1.76
 2021,Crockett,TN,"Crockett, TN",49729,11,929,39814,9915,1.25
 2019,Crockett,TX,"Crockett, TX",52168,0,573,24557,27611,2.12
 2020,Crockett,TX,"Crockett, TX",53533,3,721,30900,22633,1.73
 2021,Crockett,TX,"Crockett, TX",57013,7,862,36943,20070,1.54
 2019,Crook,OR,"Crook, OR",43670,0,1847,79157,-35487,0.55
 2020,Crook,OR,"Crook, OR",47093,8,1873,80271,-33178,0.59
 2021,Crook,OR,"Crook, OR",50708,8,2644,113314,-62606,0.45
 2019,Crook,WY,"Crook, WY",48636,0,1384,59314,-10678,0.82
 2020,Crook,WY,"Crook, WY",49756,2,1200,51429,-1673,0.97
 2021,Crook,WY,"Crook, WY",51825,4,2947,126300,-74475,0.41
 2019,Crosby,TX,"Crosby, TX",41098,0,350,15000,26098,2.74
 2020,Crosby,TX,"Crosby, TX",45362,10,263,11271,34091,4.02
 2021,Crosby,TX,"Crosby, TX",52897,17,511,21900,30997,2.42
 2019,Cross,AR,"Cross, AR",35961,0,528,22629,13332,1.59
 2020,Cross,AR,"Cross, AR",40423,12,612,26229,14194,1.54
 2021,Cross,AR,"Cross, AR",42009,4,753,32271,9738,1.3
 2019,Crow Wing,MN,"Crow Wing, MN",46170,0,1323,56700,-10530,0.81
 2020,Crow Wing,MN,"Crow Wing, MN",49561,7,1395,59786,-10225,0.83
 2021,Crow Wing,MN,"Crow Wing, MN",54260,10,1671,71614,-17354,0.76
 2019,Crowley,CO,"Crowley, CO",19286,0,361,15471,3815,1.25
 2020,Crowley,CO,"Crowley, CO",21480,11,857,36729,-15249,0.58
 2021,Crowley,CO,"Crowley, CO",24314,13,587,25157,-843,0.97
 2019,Culberson,TX,"Culberson, TX",57475,0,516,22114,35361,2.6
 2020,Culberson,TX,"Culberson, TX",66079,15,403,17271,48808,3.83
 2021,Culberson,TX,"Culberson, TX",71297,8,671,28757,42540,2.48
 2019,Cullman,AL,"Cullman, AL",40047,0,988,42343,-2296,0.95
 2020,Cullman,AL,"Cullman, AL",41925,5,1061,45471,-3546,0.92
 2021,Cullman,AL,"Cullman, AL",46061,10,1354,58029,-11968,0.79
 2019,Culpeper,VA,"Culpeper, VA",49181,0,1630,69857,-20676,0.7
 2020,Culpeper,VA,"Culpeper, VA",52016,6,1756,75257,-23241,0.69
 2021,Culpeper,VA,"Culpeper, VA",55336,6,2043,87557,-32221,0.63
 2019,Cuming,NE,"Cuming, NE",64751,0,773,33129,31622,1.95
 2020,Cuming,NE,"Cuming, NE",72236,12,552,23657,48579,3.05
 2021,Cuming,NE,"Cuming, NE",71979,0,739,31671,40308,2.27
 2019,Currituck,NC,"Currituck, NC",50389,0,1890,81000,-30611,0.62
 2020,Currituck,NC,"Currituck, NC",53380,6,2011,86186,-32806,0.62
 2021,Currituck,NC,"Currituck, NC",57320,7,2739,117386,-60066,0.49
 2019,Curry,NM,"Curry, NM",44392,0,844,36171,8221,1.23
 2020,Curry,NM,"Curry, NM",48757,10,767,32871,15886,1.48
 2021,Curry,NM,"Curry, NM",52015,7,817,35014,17001,1.49
 2019,Curry,OR,"Curry, OR",45002,0,2193,93986,-48984,0.48
 2020,Curry,OR,"Curry, OR",48934,9,2180,93429,-44495,0.52
 2021,Curry,OR,"Curry, OR",53044,8,2816,120686,-67642,0.44
 2019,Custer,CO,"Custer, CO",46705,0,2028,86914,-40209,0.54
 2020,Custer,CO,"Custer, CO",49704,6,2435,104357,-54653,0.48
 2021,Custer,CO,"Custer, CO",51271,3,2458,105343,-54072,0.49
 2019,Custer,ID,"Custer, ID",43419,0,1337,57300,-13881,0.76
 2020,Custer,ID,"Custer, ID",47771,10,1197,51300,-3529,0.93
 2021,Custer,ID,"Custer, ID",48619,2,2478,106200,-57581,0.46
 2019,Custer,MT,"Custer, MT",45133,0,791,33900,11233,1.33
 2020,Custer,MT,"Custer, MT",48672,8,741,31757,16915,1.53
 2021,Custer,MT,"Custer, MT",50535,4,1173,50271,264,1.01
 2019,Custer,NE,"Custer, NE",49256,0,460,19714,29542,2.5
 2020,Custer,NE,"Custer, NE",56374,15,591,25329,31045,2.23
 2021,Custer,NE,"Custer, NE",58544,4,1008,43200,15344,1.36
 2019,Custer,OK,"Custer, OK",41388,0,718,30771,10617,1.35
 2020,Custer,OK,"Custer, OK",42941,4,853,36557,6384,1.17
 2021,Custer,OK,"Custer, OK",46226,8,820,35143,11083,1.32
 2019,Custer,SD,"Custer, SD",53960,0,1377,59014,-5054,0.91
 2020,Custer,SD,"Custer, SD",57307,6,2056,88114,-30807,0.65
 2021,Custer,SD,"Custer, SD",59756,4,3395,145500,-85744,0.41
 2019,Cuyahoga,OH,"Cuyahoga, OH",55170,0,753,32271,22899,1.71
 2020,Cuyahoga,OH,"Cuyahoga, OH",58767,7,789,33814,24953,1.74
 2021,Cuyahoga,OH,"Cuyahoga, OH",62790,7,806,34543,28247,1.82
 2019,Dade,GA,"Dade, GA",35111,0,1143,48986,-13875,0.72
 2020,Dade,GA,"Dade, GA",37634,7,1527,65443,-27809,0.58
 2021,Dade,GA,"Dade, GA",40579,8,1441,61757,-21178,0.66
 2019,Dade,MO,"Dade, MO",35396,0,448,19200,16196,1.84
 2020,Dade,MO,"Dade, MO",38902,10,868,37200,1702,1.05
 2021,Dade,MO,"Dade, MO",42127,8,815,34929,7198,1.21
 2019,Daggett,UT,"Daggett, UT",48695,0,848,36343,12352,1.34
 2020,Daggett,UT,"Daggett, UT",50894,5,914,39171,11723,1.3
 2021,Daggett,UT,"Daggett, UT",51672,2,1399,59957,-8285,0.86
 2019,Dakota,MN,"Dakota, MN",61297,0,1934,82886,-21589,0.74
 2020,Dakota,MN,"Dakota, MN",64089,5,1780,76286,-12197,0.84
 2021,Dakota,MN,"Dakota, MN",67927,6,1867,80014,-12087,0.85
 2019,Dakota,NE,"Dakota, NE",41615,0,1056,45257,-3642,0.92
 2020,Dakota,NE,"Dakota, NE",44031,6,887,38014,6017,1.16
 2021,Dakota,NE,"Dakota, NE",48756,11,1410,60429,-11673,0.81
 2019,Dale,AL,"Dale, AL",37574,0,590,25286,12288,1.49
 2020,Dale,AL,"Dale, AL",40032,7,682,29229,10803,1.37
 2021,Dale,AL,"Dale, AL",43916,10,718,30771,13145,1.43
 2019,Dallam,TX,"Dallam, TX",64391,0,520,22286,42105,2.89
 2020,Dallam,TX,"Dallam, TX",68821,7,590,25286,43535,2.72
 2021,Dallam,TX,"Dallam, TX",70511,3,833,35700,34811,1.98
 2019,Dallas,AL,"Dallas, AL",35069,0,466,19971,15098,1.76
 2020,Dallas,AL,"Dallas, AL",38762,11,443,18986,19776,2.04
 2021,Dallas,AL,"Dallas, AL",41850,8,391,16757,25093,2.5
 2019,Dallas,AR,"Dallas, AR",39012,0,291,12471,26541,3.13
 2020,Dallas,AR,"Dallas, AR",42465,9,378,16200,26265,2.62
 2021,Dallas,AR,"Dallas, AR",46261,9,516,22114,24147,2.09
 2019,Dallas,IA,"Dallas, IA",67860,0,1647,70586,-2726,0.96
 2020,Dallas,IA,"Dallas, IA",70341,4,1545,66214,4127,1.06
 2021,Dallas,IA,"Dallas, IA",73673,5,1759,75386,-1713,0.98
 2019,Dallas,MO,"Dallas, MO",34321,0,570,24429,9892,1.4
 2020,Dallas,MO,"Dallas, MO",36355,6,790,33857,2498,1.07
 2021,Dallas,MO,"Dallas, MO",38983,7,1079,46243,-7260,0.84
 2019,Dallas,TX,"Dallas, TX",64488,0,1679,71957,-7469,0.9
 2020,Dallas,TX,"Dallas, TX",66125,3,1556,66686,-561,0.99
 2021,Dallas,TX,"Dallas, TX",72218,9,1802,77229,-5011,0.94
 2019,Dane,WI,"Dane, WI",63668,0,1823,78129,-14461,0.81
 2020,Dane,WI,"Dane, WI",66677,5,1825,78214,-11537,0.85
 2021,Dane,WI,"Dane, WI",71062,7,1885,80786,-9724,0.88
 2019,Daniels,MT,"Daniels, MT",48764,0,604,25886,22878,1.88
 2020,Daniels,MT,"Daniels, MT",59209,21,686,29400,29809,2.01
 2021,Daniels,MT,"Daniels, MT",57661,-3,1012,43371,14290,1.33
 2019,Dare,NC,"Dare, NC",60562,0,2075,88929,-28367,0.68
 2020,Dare,NC,"Dare, NC",65191,8,2268,97200,-32009,0.67
 2021,Dare,NC,"Dare, NC",68887,6,3058,131057,-62170,0.53
 2019,Darke,OH,"Darke, OH",43415,0,518,22200,21215,1.96
 2020,Darke,OH,"Darke, OH",47615,10,649,27814,19801,1.71
 2021,Darke,OH,"Darke, OH",51549,8,742,31800,19749,1.62
 2019,Darlington,SC,"Darlington, SC",41182,0,688,29486,11696,1.4
 2020,Darlington,SC,"Darlington, SC",44051,7,793,33986,10065,1.3
 2021,Darlington,SC,"Darlington, SC",47845,9,954,40886,6959,1.17
 2019,Dauphin,PA,"Dauphin, PA",52037,0,864,37029,15008,1.41
 2020,Dauphin,PA,"Dauphin, PA",55487,7,1047,44871,10616,1.24
 2021,Dauphin,PA,"Dauphin, PA",58741,6,915,39214,19527,1.5
 2019,Davidson,NC,"Davidson, NC",41164,0,1014,43457,-2293,0.95
 2020,Davidson,NC,"Davidson, NC",44191,7,1238,53057,-8866,0.83
 2021,Davidson,NC,"Davidson, NC",48086,9,1280,54857,-6771,0.88
 2019,Davidson,TN,"Davidson, TN",71100,0,1685,72214,-1114,0.98
 2020,Davidson,TN,"Davidson, TN",74857,5,1864,79886,-5029,0.94
 2021,Davidson,TN,"Davidson, TN",82087,10,2237,95871,-13784,0.86
 2019,Davie,NC,"Davie, NC",50977,0,1347,57729,-6752,0.88
 2020,Davie,NC,"Davie, NC",53558,5,1445,61929,-8371,0.86
 2021,Davie,NC,"Davie, NC",57591,8,1175,50357,7234,1.14
 2019,Daviess,IN,"Daviess, IN",43822,0,719,30814,13008,1.42
 2020,Daviess,IN,"Daviess, IN",48845,12,672,28800,20045,1.7
 2021,Daviess,IN,"Daviess, IN",53008,9,942,40371,12637,1.31
 2019,Daviess,KY,"Daviess, KY",42708,0,918,39343,3365,1.09
 2020,Daviess,KY,"Daviess, KY",46394,9,876,37543,8851,1.24
 2021,Daviess,KY,"Daviess, KY",50079,8,917,39300,10779,1.27
 2019,Daviess,MO,"Daviess, MO",33034,0,647,27729,5305,1.19
 2020,Daviess,MO,"Daviess, MO",36377,10,666,28543,7834,1.27
 2021,Daviess,MO,"Daviess, MO",37739,4,981,42043,-4304,0.9
 2019,Davis,IA,"Davis, IA",39716,0,867,37157,2559,1.07
 2020,Davis,IA,"Davis, IA",41318,4,649,27814,13504,1.49
 2021,Davis,IA,"Davis, IA",44337,7,1077,46157,-1820,0.96
 2019,Davis,UT,"Davis, UT",47468,0,1904,81600,-34132,0.58
 2020,Davis,UT,"Davis, UT",50820,7,2012,86229,-35409,0.59
 2021,Davis,UT,"Davis, UT",54820,8,2570,110143,-55323,0.5
 2019,Davison,SD,"Davison, SD",52030,0,840,36000,16030,1.45
 2020,Davison,SD,"Davison, SD",55929,8,724,31029,24900,1.8
 2021,Davison,SD,"Davison, SD",59258,6,782,33514,25744,1.77
 2019,Dawes,NE,"Dawes, NE",39476,0,1376,58971,-19495,0.67
 2020,Dawes,NE,"Dawes, NE",44425,13,1559,66814,-22389,0.66
 2021,Dawes,NE,"Dawes, NE",47375,7,255,10929,36446,4.33
 2019,Dawson,GA,"Dawson, GA",48887,0,1692,72514,-23627,0.67
 2020,Dawson,GA,"Dawson, GA",50904,4,2097,89871,-38967,0.57
 2021,Dawson,GA,"Dawson, GA",53996,6,2758,118200,-64204,0.46
 2019,Dawson,MT,"Dawson, MT",44820,0,785,33643,11177,1.33
 2020,Dawson,MT,"Dawson, MT",47514,6,735,31500,16014,1.51
 2021,Dawson,MT,"Dawson, MT",47459,0,822,35229,12230,1.35
 2019,Dawson,NE,"Dawson, NE",44578,0,737,31586,12992,1.41
 2020,Dawson,NE,"Dawson, NE",48074,8,846,36257,11817,1.33
 2021,Dawson,NE,"Dawson, NE",49653,3,848,36343,13310,1.37
 2019,Dawson,TX,"Dawson, TX",40633,0,848,36343,4290,1.12
 2020,Dawson,TX,"Dawson, TX",43888,8,830,35571,8317,1.23
 2021,Dawson,TX,"Dawson, TX",46139,5,656,28114,18025,1.64
 2019,Day,SD,"Day, SD",46021,0,766,32829,13192,1.4
 2020,Day,SD,"Day, SD",62749,36,879,37671,25078,1.67
 2021,Day,SD,"Day, SD",65558,5,348,14914,50644,4.4
 2019,De Baca,NM,"De Baca, NM",48600,0,606,25971,22629,1.87
 2020,De Baca,NM,"De Baca, NM",54946,13,592,25371,29575,2.17
 2021,De Baca,NM,"De Baca, NM",56384,3,551,23614,32770,2.39
 2019,De Soto,LA,"De Soto, LA",44449,0,1143,48986,-4537,0.91
 2020,De Soto,LA,"De Soto, LA",47201,6,1367,58586,-11385,0.81
 2021,De Soto,LA,"De Soto, LA",51447,9,974,41743,9704,1.23
 2019,De Witt,IL,"De Witt, IL",46173,0,430,18429,27744,2.51
 2020,De Witt,IL,"De Witt, IL",52177,13,342,14657,37520,3.56
 2021,De Witt,IL,"De Witt, IL",57473,10,446,19114,38359,3.01
 2019,Deaf Smith,TX,"Deaf Smith, TX",50626,0,961,41186,9440,1.23
 2020,Deaf Smith,TX,"Deaf Smith, TX",55258,9,927,39729,15529,1.39
 2021,Deaf Smith,TX,"Deaf Smith, TX",60615,10,1053,45129,15486,1.34
 2019,Dearborn,IN,"Dearborn, IN",49254,0,864,37029,12225,1.33
 2020,Dearborn,IN,"Dearborn, IN",52083,6,985,42214,9869,1.23
 2021,Dearborn,IN,"Dearborn, IN",55782,7,1166,49971,5811,1.12
 2019,Decatur,GA,"Decatur, GA",34174,0,829,35529,-1355,0.96
 2020,Decatur,GA,"Decatur, GA",37395,9,969,41529,-4134,0.9
 2021,Decatur,GA,"Decatur, GA",41331,11,1212,51943,-10612,0.8
 2019,Decatur,IA,"Decatur, IA",35998,0,366,15686,20312,2.29
 2020,Decatur,IA,"Decatur, IA",38817,8,582,24943,13874,1.56
 2021,Decatur,IA,"Decatur, IA",42171,9,588,25200,16971,1.67
 2019,Decatur,IN,"Decatur, IN",45351,0,766,32829,12522,1.38
 2020,Decatur,IN,"Decatur, IN",49285,9,787,33729,15556,1.46
 2021,Decatur,IN,"Decatur, IN",53393,8,1020,43714,9679,1.22
 2019,Decatur,KS,"Decatur, KS",44564,0,412,17657,26907,2.52
 2020,Decatur,KS,"Decatur, KS",54249,22,423,18129,36120,2.99
 2021,Decatur,KS,"Decatur, KS",58270,7,546,23400,34870,2.49
 2019,Decatur,TN,"Decatur, TN",43581,0,902,38657,4924,1.13
 2020,Decatur,TN,"Decatur, TN",45823,5,865,37071,8752,1.24
 2021,Decatur,TN,"Decatur, TN",48912,7,1156,49543,-631,0.99
 2019,Deer Lodge,MT,"Deer Lodge, MT",40093,0,895,38357,1736,1.05
 2020,Deer Lodge,MT,"Deer Lodge, MT",44356,11,843,36129,8227,1.23
 2021,Deer Lodge,MT,"Deer Lodge, MT",46384,5,1569,67243,-20859,0.69
 2019,Defiance,OH,"Defiance, OH",41542,0,638,27343,14199,1.52
 2020,Defiance,OH,"Defiance, OH",45046,8,594,25457,19589,1.77
 2021,Defiance,OH,"Defiance, OH",47933,6,607,26014,21919,1.84
 2019,Dekalb,AL,"Dekalb, AL",33015,0,778,33343,-328,0.99
 2020,Dekalb,AL,"Dekalb, AL",34999,6,850,36429,-1430,0.96
 2021,Dekalb,AL,"Dekalb, AL",40026,14,1109,47529,-7503,0.84
 2019,Dekalb,GA,"Dekalb, GA",53152,0,1399,59957,-6805,0.89
 2020,Dekalb,GA,"Dekalb, GA",57129,8,1421,60900,-3771,0.94
 2021,Dekalb,GA,"Dekalb, GA",61861,8,1847,79157,-17296,0.78
 2019,Dekalb,IL,"Dekalb, IL",43643,0,959,41100,2543,1.06
 2020,Dekalb,IL,"Dekalb, IL",47312,8,1052,45086,2226,1.05
 2021,Dekalb,IL,"Dekalb, IL",51571,9,1192,51086,485,1.01
 2019,Dekalb,IN,"Dekalb, IN",45923,0,777,33300,12623,1.38
 2020,Dekalb,IN,"Dekalb, IN",48731,6,802,34371,14360,1.42
 2021,Dekalb,IN,"Dekalb, IN",51961,7,899,38529,13432,1.35
 2019,Dekalb,MO,"Dekalb, MO",34261,0,799,34243,18,1
 2020,Dekalb,MO,"Dekalb, MO",36198,6,820,35143,1055,1.03
 2021,Dekalb,MO,"Dekalb, MO",38366,6,1048,44914,-6548,0.85
 2019,Dekalb,TN,"Dekalb, TN",41954,0,1293,55414,-13460,0.76
 2020,Dekalb,TN,"Dekalb, TN",44606,6,1392,59657,-15051,0.75
 2021,Dekalb,TN,"Dekalb, TN",47634,7,1671,71614,-23980,0.67
 2019,Del Norte,CA,"Del Norte, CA",36860,0,1721,73757,-36897,0.5
 2020,Del Norte,CA,"Del Norte, CA",41309,12,1842,78943,-37634,0.52
 2021,Del Norte,CA,"Del Norte, CA",43951,6,1928,82629,-38678,0.53
 2019,Delaware,IA,"Delaware, IA",49412,0,807,34586,14826,1.43
 2020,Delaware,IA,"Delaware, IA",52538,6,1065,45643,6895,1.15
 2021,Delaware,IA,"Delaware, IA",57097,9,1032,44229,12868,1.29
 2019,Delaware,IN,"Delaware, IN",38762,0,387,16586,22176,2.34
 2020,Delaware,IN,"Delaware, IN",42000,8,456,19543,22457,2.15
 2021,Delaware,IN,"Delaware, IN",45325,8,593,25414,19911,1.78
 2019,Delaware,NY,"Delaware, NY",42770,0,853,36557,6213,1.17
 2020,Delaware,NY,"Delaware, NY",46157,8,756,32400,13757,1.42
 2021,Delaware,NY,"Delaware, NY",48644,5,1122,48086,558,1.01
 2019,Delaware,OH,"Delaware, OH",76803,0,2169,92957,-16154,0.83
 2020,Delaware,OH,"Delaware, OH",80000,4,2246,96257,-16257,0.83
 2021,Delaware,OH,"Delaware, OH",83603,5,2331,99900,-16297,0.84
 2019,Delaware,OK,"Delaware, OK",36145,0,1337,57300,-21155,0.63
 2020,Delaware,OK,"Delaware, OK",37927,5,1420,60857,-22930,0.62
 2021,Delaware,OK,"Delaware, OK",40950,8,1581,67757,-26807,0.6
 2019,Delaware,PA,"Delaware, PA",69433,0,1103,47271,22162,1.47
 2020,Delaware,PA,"Delaware, PA",72700,5,1585,67929,4771,1.07
 2021,Delaware,PA,"Delaware, PA",77180,6,1402,60086,17094,1.28
 2019,Delta,CO,"Delta, CO",38727,0,1543,66129,-27402,0.59
 2020,Delta,CO,"Delta, CO",43409,12,1682,72086,-28677,0.6
 2021,Delta,CO,"Delta, CO",46042,6,2276,97543,-51501,0.47
 2019,Delta,MI,"Delta, MI",40047,0,573,24557,15490,1.63
 2020,Delta,MI,"Delta, MI",44204,10,583,24986,19218,1.77
 2021,Delta,MI,"Delta, MI",46524,5,785,33643,12881,1.38
 2019,Delta,TX,"Delta, TX",41006,0,610,26143,14863,1.57
 2020,Delta,TX,"Delta, TX",44449,8,467,20014,24435,2.22
 2021,Delta,TX,"Delta, TX",47471,7,964,41314,6157,1.15
 2019,Denali,AK,"Denali, AK",102888,0,860,36857,66031,2.79
 2020,Denali,AK,"Denali, AK",91233,-11,695,29786,61447,3.06
 2021,Denali,AK,"Denali, AK",107916,18,1468,62914,45002,1.72
 2019,Dent,MO,"Dent, MO",35734,0,427,18300,17434,1.95
 2020,Dent,MO,"Dent, MO",39091,9,408,17486,21605,2.24
 2021,Dent,MO,"Dent, MO",41420,6,793,33986,7434,1.22
 2019,Denton,TX,"Denton, TX",62252,0,1811,77614,-15362,0.8
 2020,Denton,TX,"Denton, TX",64434,4,1756,75257,-10823,0.86
 2021,Denton,TX,"Denton, TX",68773,7,2096,89829,-21056,0.77
 2019,Denver,CO,"Denver, CO",86539,0,2516,107829,-21290,0.8
 2020,Denver,CO,"Denver, CO",89736,4,2709,116100,-26364,0.77
 2021,Denver,CO,"Denver, CO",99133,11,2920,125143,-26010,0.79
 2019,Des Moines,IA,"Des Moines, IA",50450,0,595,25500,24950,1.98
 2020,Des Moines,IA,"Des Moines, IA",53254,6,629,26957,26297,1.98
 2021,Des Moines,IA,"Des Moines, IA",56425,6,631,27043,29382,2.09
 2019,Deschutes,OR,"Deschutes, OR",58666,0,2402,102943,-44277,0.57
 2020,Deschutes,OR,"Deschutes, OR",63872,9,2343,100414,-36542,0.64
 2021,Deschutes,OR,"Deschutes, OR",67743,6,3368,144343,-76600,0.47
 2019,Desha,AR,"Desha, AR",38458,0,308,13200,25258,2.91
 2020,Desha,AR,"Desha, AR",45111,17,419,17957,27154,2.51
 2021,Desha,AR,"Desha, AR",48464,7,694,29743,18721,1.63
 2019,Desoto,FL,"Desoto, FL",28389,0,1069,45814,-17425,0.62
 2020,Desoto,FL,"Desoto, FL",30286,7,1339,57386,-27100,0.53
 2021,Desoto,FL,"Desoto, FL",32873,9,1524,65314,-32441,0.5
 2019,Desoto,MS,"Desoto, MS",44019,0,1269,54386,-10367,0.81
 2020,Desoto,MS,"Desoto, MS",47078,7,1389,59529,-12451,0.79
 2021,Desoto,MS,"Desoto, MS",50982,8,1859,79671,-28689,0.64
 2019,Deuel,NE,"Deuel, NE",40961,0,623,26700,14261,1.53
 2020,Deuel,NE,"Deuel, NE",43499,6,489,20957,22542,2.08
 2021,Deuel,NE,"Deuel, NE",46093,6,960,41143,4950,1.12
 2019,Deuel,SD,"Deuel, SD",50684,0,651,27900,22784,1.82
 2020,Deuel,SD,"Deuel, SD",60006,18,938,40200,19806,1.49
 2021,Deuel,SD,"Deuel, SD",62580,4,904,38743,23837,1.62
 2019,Dewey,OK,"Dewey, OK",53322,0,313,13414,39908,3.98
 2020,Dewey,OK,"Dewey, OK",51015,-4,599,25671,25344,1.99
 2021,Dewey,OK,"Dewey, OK",53807,6,485,20786,33021,2.59
 2019,Dewitt,TX,"Dewitt, TX",60771,0,782,33514,27257,1.81
 2020,Dewitt,TX,"Dewitt, TX",59557,-2,711,30471,29086,1.95
 2021,Dewitt,TX,"Dewitt, TX",66916,12,961,41186,25730,1.62
 2019,Dickens,TX,"Dickens, TX",40807,0,291,12471,28336,3.27
 2020,Dickens,TX,"Dickens, TX",46630,14,501,21471,25159,2.17
 2021,Dickens,TX,"Dickens, TX",50869,9,122,5229,45640,9.73
 2019,Dickenson,VA,"Dickenson, VA",33821,0,373,15986,17835,2.12
 2020,Dickenson,VA,"Dickenson, VA",37442,11,429,18386,19056,2.04
 2021,Dickenson,VA,"Dickenson, VA",41437,11,347,14871,26566,2.79
 2019,Dickey,ND,"Dickey, ND",61984,0,585,25071,36913,2.47
 2020,Dickey,ND,"Dickey, ND",68779,11,457,19586,49193,3.51
 2021,Dickey,ND,"Dickey, ND",73312,7,934,40029,33283,1.83
 2019,Dickinson,IA,"Dickinson, IA",61429,0,1552,66514,-5085,0.92
 2020,Dickinson,IA,"Dickinson, IA",63560,4,1390,59571,3989,1.07
 2021,Dickinson,IA,"Dickinson, IA",69628,10,1390,59571,10057,1.17
 2019,Dickinson,KS,"Dickinson, KS",42596,0,545,23357,19239,1.82
 2020,Dickinson,KS,"Dickinson, KS",46708,10,517,22157,24551,2.11
 2021,Dickinson,KS,"Dickinson, KS",49255,6,596,25543,23712,1.93
 2019,Dickinson,MI,"Dickinson, MI",46741,0,617,26443,20298,1.77
 2020,Dickinson,MI,"Dickinson, MI",50975,9,620,26571,24404,1.92
 2021,Dickinson,MI,"Dickinson, MI",55335,9,802,34371,20964,1.61
 2019,Dickson,TN,"Dickson, TN",43611,0,1263,54129,-10518,0.81
 2020,Dickson,TN,"Dickson, TN",45932,5,1370,58714,-12782,0.78
 2021,Dickson,TN,"Dickson, TN",50218,9,1982,84943,-34725,0.59
 2019,Dillingham,AK,"Dillingham, AK",58303,0,1795,76929,-18626,0.76
 2020,Dillingham,AK,"Dillingham, AK",59097,1,589,25243,33854,2.34
 2021,Dillingham,AK,"Dillingham, AK",61572,4,1528,65486,-3914,0.94
 2019,Dillon,SC,"Dillon, SC",32450,0,470,20143,12307,1.61
 2020,Dillon,SC,"Dillon, SC",35315,9,457,19586,15729,1.8
 2021,Dillon,SC,"Dillon, SC",39567,12,468,20057,19510,1.97
 2019,Dimmit,TX,"Dimmit, TX",49033,0,795,34071,14962,1.44
 2020,Dimmit,TX,"Dimmit, TX",50347,3,863,36986,13361,1.36
 2021,Dimmit,TX,"Dimmit, TX",55771,11,918,39343,16428,1.42
 2019,District Of Columbia,DC,"District Of Columbia, DC",84671,0,3006,128829,-44158,0.66
 2020,District Of Columbia,DC,"District Of Columbia, DC",89735,6,3277,140443,-50708,0.64
 2021,District Of Columbia,DC,"District Of Columbia, DC",96477,8,2828,121200,-24723,0.8
 2019,Divide,ND,"Divide, ND",58643,0,422,18086,40557,3.24
 2020,Divide,ND,"Divide, ND",65123,11,576,24686,40437,2.64
 2021,Divide,ND,"Divide, ND",66208,2,429,18386,47822,3.6
 2019,Dixie,FL,"Dixie, FL",29496,0,934,40029,-10533,0.74
 2020,Dixie,FL,"Dixie, FL",32064,9,857,36729,-4665,0.87
 2021,Dixie,FL,"Dixie, FL",33813,6,1352,57943,-24130,0.58
 2019,Dixon,NE,"Dixon, NE",44757,0,675,28929,15828,1.55
 2020,Dixon,NE,"Dixon, NE",50265,12,602,25800,24465,1.95
 2021,Dixon,NE,"Dixon, NE",54144,8,526,22543,31601,2.4
 2019,Doddridge,WV,"Doddridge, WV",33526,0,743,31843,1683,1.05
 2020,Doddridge,WV,"Doddridge, WV",35077,5,735,31500,3577,1.11
 2021,Doddridge,WV,"Doddridge, WV",37685,7,776,33257,4428,1.13
 2019,Dodge,GA,"Dodge, GA",31895,0,591,25329,6566,1.26
 2020,Dodge,GA,"Dodge, GA",34346,8,704,30171,4175,1.14
 2021,Dodge,GA,"Dodge, GA",37268,9,712,30514,6754,1.22
 2019,Dodge,MN,"Dodge, MN",47126,0,1212,51943,-4817,0.91
 2020,Dodge,MN,"Dodge, MN",52462,11,1247,53443,-981,0.98
 2021,Dodge,MN,"Dodge, MN",56410,8,1273,54557,1853,1.03
 2019,Dodge,NE,"Dodge, NE",48081,0,885,37929,10152,1.27
 2020,Dodge,NE,"Dodge, NE",52163,9,859,36814,15349,1.42
 2021,Dodge,NE,"Dodge, NE",56298,8,1173,50271,6027,1.12
 2019,Dodge,WI,"Dodge, WI",45199,0,1008,43200,1999,1.05
 2020,Dodge,WI,"Dodge, WI",47937,6,959,41100,6837,1.17
 2021,Dodge,WI,"Dodge, WI",51287,7,1067,45729,5558,1.12
 2019,Dolores,CO,"Dolores, CO",35024,0,1180,50571,-15547,0.69
 2020,Dolores,CO,"Dolores, CO",36479,4,1216,52114,-15635,0.7
 2021,Dolores,CO,"Dolores, CO",39481,8,1961,84043,-44562,0.47
 2019,Dona Ana,NM,"Dona Ana, NM",38142,0,1020,43714,-5572,0.87
 2020,Dona Ana,NM,"Dona Ana, NM",41597,9,1093,46843,-5246,0.89
 2021,Dona Ana,NM,"Dona Ana, NM",45045,8,1268,54343,-9298,0.83
 2019,Doniphan,KS,"Doniphan, KS",42529,0,374,16029,26500,2.65
 2020,Doniphan,KS,"Doniphan, KS",46313,9,506,21686,24627,2.14
 2021,Doniphan,KS,"Doniphan, KS",48727,5,427,18300,30427,2.66
 2019,Donley,TX,"Donley, TX",44711,0,543,23271,21440,1.92
 2020,Donley,TX,"Donley, TX",46722,5,601,25757,20965,1.81
 2021,Donley,TX,"Donley, TX",50574,8,1407,60300,-9726,0.84
 2019,Dooly,GA,"Dooly, GA",37552,0,752,32229,5323,1.17
 2020,Dooly,GA,"Dooly, GA",40132,7,667,28586,11546,1.4
 2021,Dooly,GA,"Dooly, GA",43689,9,571,24471,19218,1.79
 2019,Door,WI,"Door, WI",61746,0,1416,60686,1060,1.02
 2020,Door,WI,"Door, WI",64481,4,1709,73243,-8762,0.88
 2021,Door,WI,"Door, WI",68172,6,2047,87729,-19557,0.78
 2019,Dorchester,MD,"Dorchester, MD",46221,0,974,41743,4478,1.11
 2020,Dorchester,MD,"Dorchester, MD",49363,7,1067,45729,3634,1.08
 2021,Dorchester,MD,"Dorchester, MD",54075,10,1174,50314,3761,1.07
 2019,Dorchester,SC,"Dorchester, SC",41157,0,1348,57771,-16614,0.71
 2020,Dorchester,SC,"Dorchester, SC",43321,5,1419,60814,-17493,0.71
 2021,Dorchester,SC,"Dorchester, SC",46857,8,1711,73329,-26472,0.64
 2019,Dougherty,GA,"Dougherty, GA",36587,0,426,18257,18330,2
 2020,Dougherty,GA,"Dougherty, GA",40942,12,485,20786,20156,1.97
 2021,Dougherty,GA,"Dougherty, GA",44575,9,467,20014,24561,2.23
 2019,Douglas,CO,"Douglas, CO",77986,0,2872,123086,-45100,0.63
 2020,Douglas,CO,"Douglas, CO",81637,5,3061,131186,-49549,0.62
 2021,Douglas,CO,"Douglas, CO",87841,8,3732,159943,-72102,0.55
 2019,Douglas,GA,"Douglas, GA",37339,0,1164,49886,-12547,0.75
 2020,Douglas,GA,"Douglas, GA",41066,10,1173,50271,-9205,0.82
 2021,Douglas,GA,"Douglas, GA",44779,9,1642,70371,-25592,0.64
 2019,Douglas,IL,"Douglas, IL",50063,0,533,22843,27220,2.19
 2020,Douglas,IL,"Douglas, IL",54821,10,558,23914,30907,2.29
 2021,Douglas,IL,"Douglas, IL",60587,11,611,26186,34401,2.31
 2019,Douglas,KS,"Douglas, KS",46612,0,1491,63900,-17288,0.73
 2020,Douglas,KS,"Douglas, KS",49290,6,1522,65229,-15939,0.76
 2021,Douglas,KS,"Douglas, KS",51703,5,1704,73029,-21326,0.71
 2019,Douglas,MN,"Douglas, MN",51776,0,1359,58243,-6467,0.89
 2020,Douglas,MN,"Douglas, MN",55854,8,1426,61114,-5260,0.91
 2021,Douglas,MN,"Douglas, MN",59909,7,1366,58543,1366,1.02
 2019,Douglas,MO,"Douglas, MO",32368,0,680,29143,3225,1.11
 2020,Douglas,MO,"Douglas, MO",35738,10,856,36686,-948,0.97
 2021,Douglas,MO,"Douglas, MO",37992,6,1113,47700,-9708,0.8
 2019,Douglas,NE,"Douglas, NE",63204,0,1404,60171,3033,1.05
 2020,Douglas,NE,"Douglas, NE",64768,3,1420,60857,3911,1.06
 2021,Douglas,NE,"Douglas, NE",68699,6,1317,56443,12256,1.22
 2019,Douglas,NV,"Douglas, NV",77239,0,2868,122914,-45675,0.63
 2020,Douglas,NV,"Douglas, NV",81033,5,3420,146571,-65538,0.55
 2021,Douglas,NV,"Douglas, NV",87214,8,4212,180514,-93300,0.48
 2019,Douglas,OR,"Douglas, OR",42488,0,1511,64757,-22269,0.66
 2020,Douglas,OR,"Douglas, OR",46948,11,1505,64500,-17552,0.73
 2021,Douglas,OR,"Douglas, OR",50595,8,1810,77571,-26976,0.65
 2019,Douglas,SD,"Douglas, SD",59865,0,309,13243,46622,4.52
 2020,Douglas,SD,"Douglas, SD",61017,2,535,22929,38088,2.66
 2021,Douglas,SD,"Douglas, SD",67626,11,658,28200,39426,2.4
 2019,Douglas,WA,"Douglas, WA",41616,0,1725,73929,-32313,0.56
 2020,Douglas,WA,"Douglas, WA",45899,10,1900,81429,-35530,0.56
 2021,Douglas,WA,"Douglas, WA",49290,7,2252,96514,-47224,0.51
 2019,Douglas,WI,"Douglas, WI",44172,0,879,37671,6501,1.17
 2020,Douglas,WI,"Douglas, WI",46003,4,1059,45386,617,1.01
 2021,Douglas,WI,"Douglas, WI",49872,8,1022,43800,6072,1.14
 2019,Drew,AR,"Drew, AR",38788,0,725,31071,7717,1.25
 2020,Drew,AR,"Drew, AR",42476,10,751,32186,10290,1.32
 2021,Drew,AR,"Drew, AR",45391,7,843,36129,9262,1.26
 2019,Dubois,IN,"Dubois, IN",54920,0,944,40457,14463,1.36
 2020,Dubois,IN,"Dubois, IN",58283,6,1055,45214,13069,1.29
 2021,Dubois,IN,"Dubois, IN",60954,5,1253,53700,7254,1.14
 2019,Dubuque,IA,"Dubuque, IA",50370,0,1218,52200,-1830,0.96
 2020,Dubuque,IA,"Dubuque, IA",53684,7,1300,55714,-2030,0.96
 2021,Dubuque,IA,"Dubuque, IA",56782,6,1410,60429,-3647,0.94
 2019,Duchesne,UT,"Duchesne, UT",38842,0,821,35186,3656,1.1
 2020,Duchesne,UT,"Duchesne, UT",41279,6,891,38186,3093,1.08
 2021,Duchesne,UT,"Duchesne, UT",42903,4,1716,73543,-30640,0.58
 2019,Dukes,MA,"Dukes, MA",79853,0,6921,296614,-216761,0.27
 2020,Dukes,MA,"Dukes, MA",81631,2,7029,301243,-219612,0.27
 2021,Dukes,MA,"Dukes, MA",86341,6,13000,557143,-470802,0.15
 2019,Dundy,NE,"Dundy, NE",71482,0,249,10671,60811,6.7
 2020,Dundy,NE,"Dundy, NE",85446,20,408,17486,67960,4.89
 2021,Dundy,NE,"Dundy, NE",93788,10,604,25886,67902,3.62
 2019,Dunklin,MO,"Dunklin, MO",36417,0,375,16071,20346,2.27
 2020,Dunklin,MO,"Dunklin, MO",39435,8,391,16757,22678,2.35
 2021,Dunklin,MO,"Dunklin, MO",43809,11,427,18300,25509,2.39
 2019,Dunn,ND,"Dunn, ND",74483,0,1222,52371,22112,1.42
 2020,Dunn,ND,"Dunn, ND",73707,-1,1333,57129,16578,1.29
 2021,Dunn,ND,"Dunn, ND",80976,10,1285,55071,25905,1.47
 2019,Dunn,WI,"Dunn, WI",41558,0,967,41443,115,1
 2020,Dunn,WI,"Dunn, WI",44970,8,1076,46114,-1144,0.98
 2021,Dunn,WI,"Dunn, WI",47673,6,1227,52586,-4913,0.91
 2019,Dupage,IL,"Dupage, IL",76075,0,1890,81000,-4925,0.94
 2020,Dupage,IL,"Dupage, IL",79901,5,1900,81429,-1528,0.98
 2021,Dupage,IL,"Dupage, IL",85498,7,1874,80314,5184,1.06
 2019,Duplin,NC,"Duplin, NC",41559,0,751,32186,9373,1.29
 2020,Duplin,NC,"Duplin, NC",44729,8,873,37414,7315,1.2
 2021,Duplin,NC,"Duplin, NC",51968,16,1256,53829,-1861,0.97
 2019,Durham,NC,"Durham, NC",52438,0,1548,66343,-13905,0.79
 2020,Durham,NC,"Durham, NC",55464,6,1619,69386,-13922,0.8
 2021,Durham,NC,"Durham, NC",60330,9,2033,87129,-26799,0.69
 2019,Dutchess,NY,"Dutchess, NY",59590,0,1642,70371,-10781,0.85
 2020,Dutchess,NY,"Dutchess, NY",63333,6,1910,81857,-18524,0.77
 2021,Dutchess,NY,"Dutchess, NY",67256,6,2126,91114,-23858,0.74
 2019,Duval,FL,"Duval, FL",47097,0,1154,49457,-2360,0.95
 2020,Duval,FL,"Duval, FL",50307,7,1165,49929,378,1.01
 2021,Duval,FL,"Duval, FL",54354,8,1386,59400,-5046,0.92
 2019,Duval,TX,"Duval, TX",43378,0,602,25800,17578,1.68
 2020,Duval,TX,"Duval, TX",47167,9,550,23571,23596,2
 2021,Duval,TX,"Duval, TX",51887,10,534,22886,29001,2.27
 2019,Dyer,TN,"Dyer, TN",42418,0,701,30043,12375,1.41
 2020,Dyer,TN,"Dyer, TN",46124,9,690,29571,16553,1.56
 2021,Dyer,TN,"Dyer, TN",51559,12,594,25457,26102,2.03
 2019,Eagle,CO,"Eagle, CO",84648,0,4007,171729,-87081,0.49
 2020,Eagle,CO,"Eagle, CO",91432,8,4476,191829,-100397,0.48
 2021,Eagle,CO,"Eagle, CO",97255,6,2841,121757,-24502,0.8
 2019,Early,GA,"Early, GA",36938,0,619,26529,10409,1.39
 2020,Early,GA,"Early, GA",40192,9,435,18643,21549,2.16
 2021,Early,GA,"Early, GA",43650,9,606,25971,17679,1.68
 2019,East Baton Rouge,LA,"East Baton Rouge, LA",51846,0,1142,48943,2903,1.06
 2020,East Baton Rouge,LA,"East Baton Rouge, LA",55983,8,1167,50014,5969,1.12
 2021,East Baton Rouge,LA,"East Baton Rouge, LA",59352,6,1512,64800,-5448,0.92
 2019,East Carroll,LA,"East Carroll, LA",31647,0,790,33857,-2210,0.93
 2020,East Carroll,LA,"East Carroll, LA",36557,16,767,32871,3686,1.11
 2021,East Carroll,LA,"East Carroll, LA",39981,9,1270,54429,-14448,0.73
 2019,East Feliciana,LA,"East Feliciana, LA",41686,0,1031,44186,-2500,0.94
 2020,East Feliciana,LA,"East Feliciana, LA",44155,6,1222,52371,-8216,0.84
 2021,East Feliciana,LA,"East Feliciana, LA",47562,8,1672,71657,-24095,0.66
 2019,Eaton,MI,"Eaton, MI",43887,0,906,38829,5058,1.13
 2020,Eaton,MI,"Eaton, MI",47981,9,921,39471,8510,1.22
 2021,Eaton,MI,"Eaton, MI",50743,6,1038,44486,6257,1.14
 2019,Eau Claire,WI,"Eau Claire, WI",49605,0,1235,52929,-3324,0.94
 2020,Eau Claire,WI,"Eau Claire, WI",52528,6,1322,56657,-4129,0.93
 2021,Eau Claire,WI,"Eau Claire, WI",55693,6,1425,61071,-5378,0.91
 2019,Echols,GA,"Echols, GA",30257,0,456,19543,10714,1.55
 2020,Echols,GA,"Echols, GA",34554,14,143,6129,28425,5.64
 2021,Echols,GA,"Echols, GA",36062,4,579,24814,11248,1.45
 2019,Ector,TX,"Ector, TX",52948,0,1212,51943,1005,1.02
 2020,Ector,TX,"Ector, TX",49351,-7,1239,53100,-3749,0.93
 2021,Ector,TX,"Ector, TX",53610,9,1096,46971,6639,1.14
 2019,Eddy,ND,"Eddy, ND",57092,0,288,12343,44749,4.63
 2020,Eddy,ND,"Eddy, ND",69336,21,493,21129,48207,3.28
 2021,Eddy,ND,"Eddy, ND",72571,5,379,16243,56328,4.47
 2019,Eddy,NM,"Eddy, NM",59246,0,1128,48343,10903,1.23
 2020,Eddy,NM,"Eddy, NM",59518,1,1352,57943,1575,1.03
 2021,Eddy,NM,"Eddy, NM",62888,6,1147,49157,13731,1.28
 2019,Edgar,IL,"Edgar, IL",41888,0,343,14700,27188,2.85
 2020,Edgar,IL,"Edgar, IL",48317,15,281,12043,36274,4.01
 2021,Edgar,IL,"Edgar, IL",54641,13,357,15300,39341,3.57
 2019,Edgecombe,NC,"Edgecombe, NC",37462,0,339,14529,22933,2.58
 2020,Edgecombe,NC,"Edgecombe, NC",40755,9,462,19800,20955,2.06
 2021,Edgecombe,NC,"Edgecombe, NC",45069,11,496,21257,23812,2.12
 2019,Edgefield,SC,"Edgefield, SC",39389,0,1158,49629,-10240,0.79
 2020,Edgefield,SC,"Edgefield, SC",42991,9,1154,49457,-6466,0.87
 2021,Edgefield,SC,"Edgefield, SC",45299,5,1421,60900,-15601,0.74
 2019,Edmonson,KY,"Edmonson, KY",34947,0,1011,43329,-8382,0.81
 2020,Edmonson,KY,"Edmonson, KY",37853,8,1015,43500,-5647,0.87
 2021,Edmonson,KY,"Edmonson, KY",41099,9,1180,50571,-9472,0.81
 2019,Edmunds,SD,"Edmunds, SD",52408,0,767,32871,19537,1.59
 2020,Edmunds,SD,"Edmunds, SD",64747,24,499,21386,43361,3.03
 2021,Edmunds,SD,"Edmunds, SD",77988,21,1142,48943,29045,1.59
 2019,Edwards,IL,"Edwards, IL",41882,0,280,12000,29882,3.49
 2020,Edwards,IL,"Edwards, IL",46220,10,298,12771,33449,3.62
 2021,Edwards,IL,"Edwards, IL",51628,12,529,22671,28957,2.28
 2019,Edwards,KS,"Edwards, KS",51294,0,283,12129,39165,4.23
 2020,Edwards,KS,"Edwards, KS",61594,20,282,12086,49508,5.1
 2021,Edwards,KS,"Edwards, KS",68555,11,414,17743,50812,3.86
 2019,Edwards,TX,"Edwards, TX",62452,0,1097,47014,15438,1.33
 2020,Edwards,TX,"Edwards, TX",73295,17,1117,47871,25424,1.53
 2021,Edwards,TX,"Edwards, TX",73981,1,3926,168257,-94276,0.44
 2019,Effingham,GA,"Effingham, GA",42320,0,1106,47400,-5080,0.89
 2020,Effingham,GA,"Effingham, GA",44887,6,1229,52671,-7784,0.85
 2021,Effingham,GA,"Effingham, GA",48212,7,1476,63257,-15045,0.76
 2019,Effingham,IL,"Effingham, IL",50578,0,755,32357,18221,1.56
 2020,Effingham,IL,"Effingham, IL",55724,10,769,32957,22767,1.69
 2021,Effingham,IL,"Effingham, IL",61218,10,864,37029,24189,1.65
 2019,El Dorado,CA,"El Dorado, CA",69408,0,2699,115671,-46263,0.6
 2020,El Dorado,CA,"El Dorado, CA",74679,8,2672,114514,-39835,0.65
 2021,El Dorado,CA,"El Dorado, CA",78525,5,3237,138729,-60204,0.57
 2019,El Paso,CO,"El Paso, CO",51015,0,1864,79886,-28871,0.64
 2020,El Paso,CO,"El Paso, CO",54712,7,2115,90643,-35931,0.6
 2021,El Paso,CO,"El Paso, CO",58627,7,2314,99171,-40544,0.59
 2019,El Paso,TX,"El Paso, TX",37894,0,889,38100,-206,0.99
 2020,El Paso,TX,"El Paso, TX",40768,8,930,39857,911,1.02
 2021,El Paso,TX,"El Paso, TX",44064,8,1215,52071,-8007,0.85
 2019,Elbert,CO,"Elbert, CO",63234,0,2605,111643,-48409,0.57
 2020,Elbert,CO,"Elbert, CO",65896,4,2839,121671,-55775,0.54
 2021,Elbert,CO,"Elbert, CO",70961,8,3441,147471,-76510,0.48
 2019,Elbert,GA,"Elbert, GA",35196,0,854,36600,-1404,0.96
 2020,Elbert,GA,"Elbert, GA",37588,7,664,28457,9131,1.32
 2021,Elbert,GA,"Elbert, GA",41104,9,1062,45514,-4410,0.9
 2019,Elk,KS,"Elk, KS",39408,0,290,12429,26979,3.17
 2020,Elk,KS,"Elk, KS",42831,9,272,11657,31174,3.67
 2021,Elk,KS,"Elk, KS",47485,11,645,27643,19842,1.72
 2019,Elk,PA,"Elk, PA",46954,0,388,16629,30325,2.82
 2020,Elk,PA,"Elk, PA",51310,9,450,19286,32024,2.66
 2021,Elk,PA,"Elk, PA",51653,1,487,20871,30782,2.47
 2019,Elkhart,IN,"Elkhart, IN",45873,0,950,40714,5159,1.13
 2020,Elkhart,IN,"Elkhart, IN",49321,8,969,41529,7792,1.19
 2021,Elkhart,IN,"Elkhart, IN",55007,12,1047,44871,10136,1.23
 2019,Elko,NV,"Elko, NV",47458,0,1387,59443,-11985,0.8
 2020,Elko,NV,"Elko, NV",50436,6,1502,64371,-13935,0.78
 2021,Elko,NV,"Elko, NV",52754,5,2004,85886,-33132,0.61
 2019,Elliott,KY,"Elliott, KY",23319,0,892,38229,-14910,0.61
 2020,Elliott,KY,"Elliott, KY",27154,16,475,20357,6797,1.33
 2021,Elliott,KY,"Elliott, KY",29572,9,1008,43200,-13628,0.68
 2019,Ellis,KS,"Ellis, KS",46980,0,694,29743,17237,1.58
 2020,Ellis,KS,"Ellis, KS",50491,8,681,29186,21305,1.73
 2021,Ellis,KS,"Ellis, KS",53348,6,795,34071,19277,1.57
 2019,Ellis,OK,"Ellis, OK",55054,0,368,15771,39283,3.49
 2020,Ellis,OK,"Ellis, OK",53911,-2,351,15043,38868,3.58
 2021,Ellis,OK,"Ellis, OK",57564,7,518,22200,35364,2.59
 2019,Ellis,TX,"Ellis, TX",47591,0,1523,65271,-17680,0.73
 2020,Ellis,TX,"Ellis, TX",49456,4,1618,69343,-19887,0.71
 2021,Ellis,TX,"Ellis, TX",53393,8,2066,88543,-35150,0.6
 2019,Ellsworth,KS,"Ellsworth, KS",43841,0,412,17657,26184,2.48
 2020,Ellsworth,KS,"Ellsworth, KS",45169,3,454,19457,25712,2.32
 2021,Ellsworth,KS,"Ellsworth, KS",47749,6,339,14529,33220,3.29
 2019,Elmore,AL,"Elmore, AL",42234,0,1114,47743,-5509,0.88
 2020,Elmore,AL,"Elmore, AL",44683,6,1243,53271,-8588,0.84
 2021,Elmore,AL,"Elmore, AL",47381,6,1506,64543,-17162,0.73
 2019,Elmore,ID,"Elmore, ID",37417,0,1077,46157,-8740,0.81
 2020,Elmore,ID,"Elmore, ID",39343,5,1264,54171,-14828,0.73
 2021,Elmore,ID,"Elmore, ID",41884,7,1685,72214,-30330,0.58
 2019,Emanuel,GA,"Emanuel, GA",33649,0,574,24600,9049,1.37
 2020,Emanuel,GA,"Emanuel, GA",37982,13,733,31414,6568,1.21
 2021,Emanuel,GA,"Emanuel, GA",40614,7,781,33471,7143,1.21
 2019,Emery,UT,"Emery, UT",35160,0,703,30129,5031,1.17
 2020,Emery,UT,"Emery, UT",39031,11,710,30429,8602,1.28
 2021,Emery,UT,"Emery, UT",40871,5,1061,45471,-4600,0.9
 2019,Emmet,IA,"Emmet, IA",44863,0,462,19800,25063,2.27
 2020,Emmet,IA,"Emmet, IA",45761,2,407,17443,28318,2.62
 2021,Emmet,IA,"Emmet, IA",51890,13,577,24729,27161,2.1
 2019,Emmet,MI,"Emmet, MI",58421,0,1512,64800,-6379,0.9
 2020,Emmet,MI,"Emmet, MI",63571,9,1692,72514,-8943,0.88
 2021,Emmet,MI,"Emmet, MI",66826,5,2258,96771,-29945,0.69
 2019,Emmons,ND,"Emmons, ND",48876,0,644,27600,21276,1.77
 2020,Emmons,ND,"Emmons, ND",64339,32,559,23957,40382,2.69
 2021,Emmons,ND,"Emmons, ND",72883,13,345,14786,58097,4.93
 2019,Erath,TX,"Erath, TX",42446,0,1061,45471,-3025,0.93
 2020,Erath,TX,"Erath, TX",44773,6,1350,57857,-13084,0.77
 2021,Erath,TX,"Erath, TX",46906,5,1442,61800,-14894,0.76
 2019,Erie,NY,"Erie, NY",50760,0,1008,43200,7560,1.18
 2020,Erie,NY,"Erie, NY",55229,9,1048,44914,10315,1.23
 2021,Erie,NY,"Erie, NY",57625,4,1111,47614,10011,1.21
 2019,Erie,OH,"Erie, OH",55178,0,908,38914,16264,1.42
 2020,Erie,OH,"Erie, OH",54141,-2,1061,45471,8670,1.19
 2021,Erie,OH,"Erie, OH",58239,8,1104,47314,10925,1.23
 2019,Erie,PA,"Erie, PA",45883,0,677,29014,16869,1.58
 2020,Erie,PA,"Erie, PA",49969,9,669,28671,21298,1.74
 2021,Erie,PA,"Erie, PA",52747,6,687,29443,23304,1.79
 2019,Escambia,AL,"Escambia, AL",33325,0,645,27643,5682,1.21
 2020,Escambia,AL,"Escambia, AL",36134,8,612,26229,9905,1.38
 2021,Escambia,AL,"Escambia, AL",39363,9,859,36814,2549,1.07
 2019,Escambia,FL,"Escambia, FL",44739,0,1200,51429,-6690,0.87
 2020,Escambia,FL,"Escambia, FL",47837,7,1297,55586,-7749,0.86
 2021,Escambia,FL,"Escambia, FL",51808,8,1589,68100,-16292,0.76
 2019,Esmeralda,NV,"Esmeralda, NV",51386,0,4362,186943,-135557,0.27
 2020,Esmeralda,NV,"Esmeralda, NV",47507,-8,1667,71443,-23936,0.66
 2021,Esmeralda,NV,"Esmeralda, NV",55007,16,835,35786,19221,1.54
 2019,Essex,MA,"Essex, MA",68305,0,2471,105900,-37595,0.64
 2020,Essex,MA,"Essex, MA",73101,7,2894,124029,-50928,0.59
 2021,Essex,MA,"Essex, MA",78093,7,2795,119786,-41693,0.65
 2019,Essex,NJ,"Essex, NJ",63975,0,1873,80271,-16296,0.8
 2020,Essex,NJ,"Essex, NJ",68192,7,1974,84600,-16408,0.81
 2021,Essex,NJ,"Essex, NJ",74310,9,2026,86829,-12519,0.86
 2019,Essex,NY,"Essex, NY",47408,0,998,42771,4637,1.11
 2020,Essex,NY,"Essex, NY",51020,8,1061,45471,5549,1.12
 2021,Essex,NY,"Essex, NY",54109,6,975,41786,12323,1.29
 2019,Essex,VA,"Essex, VA",43817,0,1083,46414,-2597,0.94
 2020,Essex,VA,"Essex, VA",47839,9,1133,48557,-718,0.99
 2021,Essex,VA,"Essex, VA",51780,8,1398,59914,-8134,0.86
 2019,Essex,VT,"Essex, VT",41733,0,790,33857,7876,1.23
 2020,Essex,VT,"Essex, VT",45107,8,637,27300,17807,1.65
 2021,Essex,VT,"Essex, VT",48120,7,1132,48514,-394,0.99
 2019,Estill,KY,"Estill, KY",32896,0,571,24471,8425,1.34
 2020,Estill,KY,"Estill, KY",36458,11,666,28543,7915,1.28
 2021,Estill,KY,"Estill, KY",40235,10,793,33986,6249,1.18
 2019,Etowah,AL,"Etowah, AL",37407,0,728,31200,6207,1.2
 2020,Etowah,AL,"Etowah, AL",39795,6,824,35314,4481,1.13
 2021,Etowah,AL,"Etowah, AL",42558,7,943,40414,2144,1.05
 2019,Eureka,NV,"Eureka, NV",47549,0,1104,47314,235,1
 2020,Eureka,NV,"Eureka, NV",47833,1,671,28757,19076,1.66
 2021,Eureka,NV,"Eureka, NV",49606,4,1182,50657,-1051,0.98
 2019,Evangeline,LA,"Evangeline, LA",34441,0,438,18771,15670,1.83
 2020,Evangeline,LA,"Evangeline, LA",39226,14,579,24814,14412,1.58
 2021,Evangeline,LA,"Evangeline, LA",42109,7,871,37329,4780,1.13
 2019,Evans,GA,"Evans, GA",33693,0,704,30171,3522,1.12
 2020,Evans,GA,"Evans, GA",36770,9,851,36471,299,1.01
 2021,Evans,GA,"Evans, GA",39404,7,1093,46843,-7439,0.84
 2019,Fairbanks North Star,AK,"Fairbanks North Star, AK",59011,0,1060,45429,13582,1.3
 2020,Fairbanks North Star,AK,"Fairbanks North Star, AK",61856,5,1043,44700,17156,1.38
 2021,Fairbanks North Star,AK,"Fairbanks North Star, AK",65314,6,1204,51600,13714,1.27
 2019,Fairfield,CT,"Fairfield, CT",116996,0,3480,149143,-32147,0.78
 2020,Fairfield,CT,"Fairfield, CT",119366,2,3386,145114,-25748,0.82
 2021,Fairfield,CT,"Fairfield, CT",127391,7,3518,150771,-23380,0.84
 2019,Fairfield,OH,"Fairfield, OH",48415,0,1178,50486,-2071,0.96
 2020,Fairfield,OH,"Fairfield, OH",52052,8,1331,57043,-4991,0.91
 2021,Fairfield,OH,"Fairfield, OH",55185,6,1337,57300,-2115,0.96
 2019,Fairfield,SC,"Fairfield, SC",40794,0,1043,44700,-3906,0.91
 2020,Fairfield,SC,"Fairfield, SC",44890,10,1096,46971,-2081,0.96
 2021,Fairfield,SC,"Fairfield, SC",48634,8,1929,82671,-34037,0.59
 2019,Fall River,SD,"Fall River, SD",45904,0,848,36343,9561,1.26
 2020,Fall River,SD,"Fall River, SD",48905,7,972,41657,7248,1.17
 2021,Fall River,SD,"Fall River, SD",51225,5,1378,59057,-7832,0.87
 2019,Fallon,MT,"Fallon, MT",45775,0,1196,51257,-5482,0.89
 2020,Fallon,MT,"Fallon, MT",48531,6,781,33471,15060,1.45
 2021,Fallon,MT,"Fallon, MT",49165,1,599,25671,23494,1.92
 2019,Falls,TX,"Falls, TX",36678,0,439,18814,17864,1.95
 2020,Falls,TX,"Falls, TX",40389,10,655,28071,12318,1.44
 2021,Falls,TX,"Falls, TX",43658,8,629,26957,16701,1.62
 2019,Fannin,GA,"Fannin, GA",40680,0,1822,78086,-37406,0.52
 2020,Fannin,GA,"Fannin, GA",43024,6,1997,85586,-42562,0.5
 2021,Fannin,GA,"Fannin, GA",46163,7,3131,134186,-88023,0.34
 2019,Fannin,TX,"Fannin, TX",41009,0,868,37200,3809,1.1
 2020,Fannin,TX,"Fannin, TX",42843,5,970,41571,1272,1.03
 2021,Fannin,TX,"Fannin, TX",46449,8,1214,52029,-5580,0.89
 2019,Faribault,MN,"Faribault, MN",42468,0,428,18343,24125,2.32
 2020,Faribault,MN,"Faribault, MN",49095,16,445,19071,30024,2.57
 2021,Faribault,MN,"Faribault, MN",54496,11,763,32700,21796,1.67
 2019,Faulk,SD,"Faulk, SD",58078,0,0,0,58078,0
 2020,Faulk,SD,"Faulk, SD",68854,19,447,19157,49697,3.59
 2021,Faulk,SD,"Faulk, SD",80152,16,974,41743,38409,1.92
 2019,Faulkner,AR,"Faulkner, AR",40546,0,951,40757,-211,0.99
 2020,Faulkner,AR,"Faulkner, AR",43322,7,1076,46114,-2792,0.94
 2021,Faulkner,AR,"Faulkner, AR",45841,6,1379,59100,-13259,0.78
 2019,Fauquier,VA,"Fauquier, VA",71845,0,2396,102686,-30841,0.7
 2020,Fauquier,VA,"Fauquier, VA",74649,4,2774,118886,-44237,0.63
 2021,Fauquier,VA,"Fauquier, VA",78810,6,2808,120343,-41533,0.65
 2019,Fayette,AL,"Fayette, AL",35733,0,625,26786,8947,1.33
 2020,Fayette,AL,"Fayette, AL",37852,6,791,33900,3952,1.12
 2021,Fayette,AL,"Fayette, AL",41672,10,500,21429,20243,1.94
 2019,Fayette,GA,"Fayette, GA",65794,0,1908,81771,-15977,0.8
 2020,Fayette,GA,"Fayette, GA",68463,4,2047,87729,-19266,0.78
 2021,Fayette,GA,"Fayette, GA",73202,7,2308,98914,-25712,0.74
 2019,Fayette,IA,"Fayette, IA",44047,0,370,15857,28190,2.78
 2020,Fayette,IA,"Fayette, IA",47074,7,454,19457,27617,2.42
 2021,Fayette,IA,"Fayette, IA",51226,9,430,18429,32797,2.78
 2019,Fayette,IL,"Fayette, IL",36224,0,507,21729,14495,1.67
 2020,Fayette,IL,"Fayette, IL",40215,11,522,22371,17844,1.8
 2021,Fayette,IL,"Fayette, IL",44763,11,614,26314,18449,1.7
 2019,Fayette,IN,"Fayette, IN",40402,0,353,15129,25273,2.67
 2020,Fayette,IN,"Fayette, IN",43818,9,306,13114,30704,3.34
 2021,Fayette,IN,"Fayette, IN",47588,9,623,26700,20888,1.78
 2019,Fayette,KY,"Fayette, KY",52888,0,1418,60771,-7883,0.87
 2020,Fayette,KY,"Fayette, KY",56482,7,1523,65271,-8789,0.87
 2021,Fayette,KY,"Fayette, KY",59987,6,1456,62400,-2413,0.96
 2019,Fayette,OH,"Fayette, OH",39499,0,643,27557,11942,1.43
 2020,Fayette,OH,"Fayette, OH",45321,15,518,22200,23121,2.04
 2021,Fayette,OH,"Fayette, OH",47851,6,681,29186,18665,1.64
 2019,Fayette,PA,"Fayette, PA",43186,0,606,25971,17215,1.66
 2020,Fayette,PA,"Fayette, PA",47448,10,645,27643,19805,1.72
 2021,Fayette,PA,"Fayette, PA",51007,8,771,33043,17964,1.54
 2019,Fayette,TN,"Fayette, TN",58804,0,1691,72471,-13667,0.81
 2020,Fayette,TN,"Fayette, TN",62949,7,1592,68229,-5280,0.92
 2021,Fayette,TN,"Fayette, TN",68153,8,2166,92829,-24676,0.73
 2019,Fayette,TX,"Fayette, TX",59756,0,1208,51771,7985,1.15
 2020,Fayette,TX,"Fayette, TX",61840,4,1396,59829,2011,1.03
 2021,Fayette,TX,"Fayette, TX",65339,6,1740,74571,-9232,0.88
 2019,Fayette,WV,"Fayette, WV",38436,0,511,21900,16536,1.76
 2020,Fayette,WV,"Fayette, WV",40745,6,398,17057,23688,2.39
 2021,Fayette,WV,"Fayette, WV",44136,8,514,22029,22107,2
 2019,Fentress,TN,"Fentress, TN",35093,0,907,38871,-3778,0.9
 2020,Fentress,TN,"Fentress, TN",37450,7,908,38914,-1464,0.96
 2021,Fentress,TN,"Fentress, TN",40402,8,1640,70286,-29884,0.57
 2019,Fergus,MT,"Fergus, MT",44026,0,839,35957,8069,1.22
 2020,Fergus,MT,"Fergus, MT",45728,4,1231,52757,-7029,0.87
 2021,Fergus,MT,"Fergus, MT",46685,2,1199,51386,-4701,0.91
 2019,Ferry,WA,"Ferry, WA",38465,0,880,37714,751,1.02
 2020,Ferry,WA,"Ferry, WA",44164,15,1539,65957,-21793,0.67
 2021,Ferry,WA,"Ferry, WA",46847,6,1724,73886,-27039,0.63
 2019,Fillmore,MN,"Fillmore, MN",43899,0,754,32314,11585,1.36
 2020,Fillmore,MN,"Fillmore, MN",49006,12,826,35400,13606,1.38
 2021,Fillmore,MN,"Fillmore, MN",51972,6,828,35486,16486,1.46
 2019,Fillmore,NE,"Fillmore, NE",57200,0,963,41271,15929,1.39
 2020,Fillmore,NE,"Fillmore, NE",62796,10,546,23400,39396,2.68
 2021,Fillmore,NE,"Fillmore, NE",68697,9,418,17914,50783,3.83
 2019,Finney,KS,"Finney, KS",41216,0,1021,43757,-2541,0.94
 2020,Finney,KS,"Finney, KS",44599,8,1080,46286,-1687,0.96
 2021,Finney,KS,"Finney, KS",47523,7,1091,46757,766,1.02
 2019,Fisher,TX,"Fisher, TX",46330,0,509,21814,24516,2.12
 2020,Fisher,TX,"Fisher, TX",48931,6,427,18300,30631,2.67
 2021,Fisher,TX,"Fisher, TX",57245,17,571,24471,32774,2.34
 2019,Flagler,FL,"Flagler, FL",50695,0,1428,61200,-10505,0.83
 2020,Flagler,FL,"Flagler, FL",52613,4,1420,60857,-8244,0.86
 2021,Flagler,FL,"Flagler, FL",56336,7,1849,79243,-22907,0.71
 2019,Flathead,MT,"Flathead, MT",51462,0,2063,88414,-36952,0.58
 2020,Flathead,MT,"Flathead, MT",55764,8,2052,87943,-32179,0.63
 2021,Flathead,MT,"Flathead, MT",58964,6,3292,141086,-82122,0.42
 2019,Fleming,KY,"Fleming, KY",34269,0,839,35957,-1688,0.95
 2020,Fleming,KY,"Fleming, KY",38609,13,935,40071,-1462,0.96
 2021,Fleming,KY,"Fleming, KY",41490,8,1134,48600,-7110,0.85
 2019,Florence,SC,"Florence, SC",44609,0,841,36043,8566,1.24
 2020,Florence,SC,"Florence, SC",47692,7,934,40029,7663,1.19
 2021,Florence,SC,"Florence, SC",51554,8,976,41829,9725,1.23
 2019,Florence,WI,"Florence, WI",59645,0,725,31071,28574,1.92
 2020,Florence,WI,"Florence, WI",58794,-1,874,37457,21337,1.57
 2021,Florence,WI,"Florence, WI",64600,10,1189,50957,13643,1.27
 2019,Floyd,GA,"Floyd, GA",39008,0,804,34457,4551,1.13
 2020,Floyd,GA,"Floyd, GA",41411,6,1092,46800,-5389,0.88
 2021,Floyd,GA,"Floyd, GA",44803,8,1017,43586,1217,1.03
 2019,Floyd,IA,"Floyd, IA",47223,0,559,23957,23266,1.97
 2020,Floyd,IA,"Floyd, IA",49861,6,468,20057,29804,2.49
 2021,Floyd,IA,"Floyd, IA",56044,12,585,25071,30973,2.24
 2019,Floyd,IN,"Floyd, IN",55680,0,1124,48171,7509,1.16
 2020,Floyd,IN,"Floyd, IN",58165,5,1178,50486,7679,1.15
 2021,Floyd,IN,"Floyd, IN",62578,8,1053,45129,17449,1.39
 2019,Floyd,KY,"Floyd, KY",36589,0,468,20057,16532,1.82
 2020,Floyd,KY,"Floyd, KY",39909,9,595,25500,14409,1.57
 2021,Floyd,KY,"Floyd, KY",44198,11,708,30343,13855,1.46
 2019,Floyd,TX,"Floyd, TX",44395,0,336,14400,29995,3.08
 2020,Floyd,TX,"Floyd, TX",44760,1,464,19886,24874,2.25
 2021,Floyd,TX,"Floyd, TX",53292,19,149,6386,46906,8.35
 2019,Floyd,VA,"Floyd, VA",40313,0,1262,54086,-13773,0.75
 2020,Floyd,VA,"Floyd, VA",43470,8,1616,69257,-25787,0.63
 2021,Floyd,VA,"Floyd, VA",47376,9,1769,75814,-28438,0.62
 2019,Fluvanna,VA,"Fluvanna, VA",46851,0,1232,52800,-5949,0.89
 2020,Fluvanna,VA,"Fluvanna, VA",49775,6,1332,57086,-7311,0.87
 2021,Fluvanna,VA,"Fluvanna, VA",53612,8,1716,73543,-19931,0.73
 2019,Foard,TX,"Foard, TX",48955,0,216,9257,39698,5.29
 2020,Foard,TX,"Foard, TX",54722,12,1207,51729,2993,1.06
 2021,Foard,TX,"Foard, TX",61279,12,358,15343,45936,3.99
 2019,Fond Du Lac,WI,"Fond Du Lac, WI",49996,0,715,30643,19353,1.63
 2020,Fond Du Lac,WI,"Fond Du Lac, WI",53124,6,863,36986,16138,1.44
 2021,Fond Du Lac,WI,"Fond Du Lac, WI",56378,6,910,39000,17378,1.45
 2019,Ford,IL,"Ford, IL",50124,0,432,18514,31610,2.71
 2020,Ford,IL,"Ford, IL",56396,13,399,17100,39296,3.3
 2021,Ford,IL,"Ford, IL",62180,10,497,21300,40880,2.92
 2019,Ford,KS,"Ford, KS",38753,0,737,31586,7167,1.23
 2020,Ford,KS,"Ford, KS",43865,13,728,31200,12665,1.41
 2021,Ford,KS,"Ford, KS",47052,7,777,33300,13752,1.41
 2019,Forest,PA,"Forest, PA",24922,0,318,13629,11293,1.83
 2020,Forest,PA,"Forest, PA",28305,14,350,15000,13305,1.89
 2021,Forest,PA,"Forest, PA",29573,5,564,24171,5402,1.22
 2019,Forest,WI,"Forest, WI",41617,0,645,27643,13974,1.51
 2020,Forest,WI,"Forest, WI",44154,6,659,28243,15911,1.56
 2021,Forest,WI,"Forest, WI",46139,5,827,35443,10696,1.3
 2019,Forrest,MS,"Forrest, MS",36994,0,766,32829,4165,1.13
 2020,Forrest,MS,"Forrest, MS",40216,9,784,33600,6616,1.2
 2021,Forrest,MS,"Forrest, MS",42853,7,925,39643,3210,1.08
 2019,Forsyth,GA,"Forsyth, GA",66644,0,2054,88029,-21385,0.76
 2020,Forsyth,GA,"Forsyth, GA",68985,4,2035,87214,-18229,0.79
 2021,Forsyth,GA,"Forsyth, GA",73337,6,2542,108943,-35606,0.67
 2019,Forsyth,NC,"Forsyth, NC",49345,0,1212,51943,-2598,0.95
 2020,Forsyth,NC,"Forsyth, NC",52167,6,1490,63857,-11690,0.82
 2021,Forsyth,NC,"Forsyth, NC",56378,8,1374,58886,-2508,0.96
 2019,Fort Bend,TX,"Fort Bend, TX",63261,0,1602,68657,-5396,0.92
 2020,Fort Bend,TX,"Fort Bend, TX",63012,0,1581,67757,-4745,0.93
 2021,Fort Bend,TX,"Fort Bend, TX",65797,4,1941,83186,-17389,0.79
 2019,Foster,ND,"Foster, ND",58655,0,528,22629,36026,2.59
 2020,Foster,ND,"Foster, ND",73729,26,567,24300,49429,3.03
 2021,Foster,ND,"Foster, ND",75732,3,702,30086,45646,2.52
 2019,Fountain,IN,"Fountain, IN",40485,0,383,16414,24071,2.47
 2020,Fountain,IN,"Fountain, IN",44585,10,413,17700,26885,2.52
 2021,Fountain,IN,"Fountain, IN",48583,9,840,36000,12583,1.35
 2019,Franklin,AL,"Franklin, AL",34382,0,613,26271,8111,1.31
 2020,Franklin,AL,"Franklin, AL",37151,8,736,31543,5608,1.18
 2021,Franklin,AL,"Franklin, AL",40810,10,791,33900,6910,1.2
 2019,Franklin,AR,"Franklin, AR",33810,0,544,23314,10496,1.45
 2020,Franklin,AR,"Franklin, AR",35248,4,619,26529,8719,1.33
 2021,Franklin,AR,"Franklin, AR",40591,15,701,30043,10548,1.35
 2019,Franklin,FL,"Franklin, FL",36528,0,2075,88929,-52401,0.41
 2020,Franklin,FL,"Franklin, FL",38995,7,1951,83614,-44619,0.47
 2021,Franklin,FL,"Franklin, FL",41878,7,2925,125357,-83479,0.33
 2019,Franklin,GA,"Franklin, GA",34939,0,984,42171,-7232,0.83
 2020,Franklin,GA,"Franklin, GA",35255,1,961,41186,-5931,0.86
 2021,Franklin,GA,"Franklin, GA",39616,12,1315,56357,-16741,0.7
 2019,Franklin,IA,"Franklin, IA",47999,0,644,27600,20399,1.74
 2020,Franklin,IA,"Franklin, IA",50950,6,571,24471,26479,2.08
 2021,Franklin,IA,"Franklin, IA",59466,17,532,22800,36666,2.61
 2019,Franklin,ID,"Franklin, ID",36323,0,1507,64586,-28263,0.56
 2020,Franklin,ID,"Franklin, ID",40038,10,1886,80829,-40791,0.5
 2021,Franklin,ID,"Franklin, ID",43472,9,2645,113357,-69885,0.38
 2019,Franklin,IL,"Franklin, IL",38161,0,327,14014,24147,2.72
 2020,Franklin,IL,"Franklin, IL",42023,10,312,13371,28652,3.14
 2021,Franklin,IL,"Franklin, IL",45473,8,287,12300,33173,3.7
 2019,Franklin,IN,"Franklin, IN",47166,0,936,40114,7052,1.18
 2020,Franklin,IN,"Franklin, IN",50978,8,840,36000,14978,1.42
 2021,Franklin,IN,"Franklin, IN",54451,7,1101,47186,7265,1.15
 2019,Franklin,KS,"Franklin, KS",43532,0,843,36129,7403,1.2
 2020,Franklin,KS,"Franklin, KS",46307,6,804,34457,11850,1.34
 2021,Franklin,KS,"Franklin, KS",49652,7,924,39600,10052,1.25
 2019,Franklin,KY,"Franklin, KY",43203,0,989,42386,817,1.02
 2020,Franklin,KY,"Franklin, KY",46755,8,1134,48600,-1845,0.96
 2021,Franklin,KY,"Franklin, KY",49985,7,1112,47657,2328,1.05
 2019,Franklin,LA,"Franklin, LA",33029,0,480,20571,12458,1.61
 2020,Franklin,LA,"Franklin, LA",37627,14,598,25629,11998,1.47
 2021,Franklin,LA,"Franklin, LA",40589,8,625,26786,13803,1.52
 2019,Franklin,MA,"Franklin, MA",56241,0,1167,50014,6227,1.12
 2020,Franklin,MA,"Franklin, MA",60297,7,1239,53100,7197,1.14
 2021,Franklin,MA,"Franklin, MA",63366,5,1516,64971,-1605,0.98
 2019,Franklin,ME,"Franklin, ME",40801,0,1074,46029,-5228,0.89
 2020,Franklin,ME,"Franklin, ME",44219,8,1181,50614,-6395,0.87
 2021,Franklin,ME,"Franklin, ME",47206,7,1130,48429,-1223,0.97
 2019,Franklin,MO,"Franklin, MO",46380,0,1029,44100,2280,1.05
 2020,Franklin,MO,"Franklin, MO",49094,6,1125,48214,880,1.02
 2021,Franklin,MO,"Franklin, MO",51952,6,1367,58586,-6634,0.89
 2019,Franklin,MS,"Franklin, MS",35908,0,754,32314,3594,1.11
 2020,Franklin,MS,"Franklin, MS",38685,8,584,25029,13656,1.55
 2021,Franklin,MS,"Franklin, MS",40443,5,710,30429,10014,1.33
 2019,Franklin,NC,"Franklin, NC",38629,0,1384,59314,-20685,0.65
 2020,Franklin,NC,"Franklin, NC",41482,7,1382,59229,-17747,0.7
 2021,Franklin,NC,"Franklin, NC",44996,9,1822,78086,-33090,0.58
 2019,Franklin,NE,"Franklin, NE",52677,0,430,18429,34248,2.86
 2020,Franklin,NE,"Franklin, NE",62114,18,382,16371,45743,3.79
 2021,Franklin,NE,"Franklin, NE",68092,10,834,35743,32349,1.91
 2019,Franklin,NY,"Franklin, NY",41327,0,671,28757,12570,1.44
 2020,Franklin,NY,"Franklin, NY",45004,9,704,30171,14833,1.49
 2021,Franklin,NY,"Franklin, NY",48658,8,764,32743,15915,1.49
 2019,Franklin,OH,"Franklin, OH",51386,0,1185,50786,600,1.01
 2020,Franklin,OH,"Franklin, OH",55376,8,1242,53229,2147,1.04
 2021,Franklin,OH,"Franklin, OH",58689,6,1268,54343,4346,1.08
 2019,Franklin,PA,"Franklin, PA",48017,0,1007,43157,4860,1.11
 2020,Franklin,PA,"Franklin, PA",51665,8,1081,46329,5336,1.12
 2021,Franklin,PA,"Franklin, PA",55139,7,1188,50914,4225,1.08
 2019,Franklin,TN,"Franklin, TN",40494,0,1434,61457,-20963,0.66
 2020,Franklin,TN,"Franklin, TN",43348,7,1476,63257,-19909,0.69
 2021,Franklin,TN,"Franklin, TN",45975,6,1984,85029,-39054,0.54
 2019,Franklin,TX,"Franklin, TX",44331,0,1997,85586,-41255,0.52
 2020,Franklin,TX,"Franklin, TX",47316,7,1668,71486,-24170,0.66
 2021,Franklin,TX,"Franklin, TX",51926,10,1337,57300,-5374,0.91
 2019,Franklin,VA,"Franklin, VA",44047,0,1742,74657,-30610,0.59
 2020,Franklin,VA,"Franklin, VA",47241,7,1840,78857,-31616,0.6
 2021,Franklin,VA,"Franklin, VA",50264,6,1825,78214,-27950,0.64
 2019,Franklin,VT,"Franklin, VT",49217,0,1207,51729,-2512,0.95
 2020,Franklin,VT,"Franklin, VT",52392,7,1188,50914,1478,1.03
 2021,Franklin,VT,"Franklin, VT",54756,5,1476,63257,-8501,0.87
 2019,Franklin,WA,"Franklin, WA",39324,0,1458,62486,-23162,0.63
 2020,Franklin,WA,"Franklin, WA",42756,9,1547,66300,-23544,0.64
 2021,Franklin,WA,"Franklin, WA",45937,7,1835,78643,-32706,0.58
 2019,Frederick,MD,"Frederick, MD",62317,0,1911,81900,-19583,0.76
 2020,Frederick,MD,"Frederick, MD",65338,5,1926,82543,-17205,0.79
 2021,Frederick,MD,"Frederick, MD",68704,5,2301,98614,-29910,0.7
 2019,Freeborn,MN,"Freeborn, MN",44984,0,685,29357,15627,1.53
 2020,Freeborn,MN,"Freeborn, MN",49480,10,683,29271,20209,1.69
 2021,Freeborn,MN,"Freeborn, MN",53790,9,651,27900,25890,1.93
 2019,Freestone,TX,"Freestone, TX",39140,0,791,33900,5240,1.15
 2020,Freestone,TX,"Freestone, TX",40983,5,799,34243,6740,1.2
 2021,Freestone,TX,"Freestone, TX",44014,7,846,36257,7757,1.21
 2019,Fremont,CO,"Fremont, CO",35147,0,1500,64286,-29139,0.55
 2020,Fremont,CO,"Fremont, CO",38325,9,1475,63214,-24889,0.61
 2021,Fremont,CO,"Fremont, CO",41017,7,1777,76157,-35140,0.54
 2019,Fremont,IA,"Fremont, IA",49423,0,349,14957,34466,3.3
 2020,Fremont,IA,"Fremont, IA",53171,8,531,22757,30414,2.34
 2021,Fremont,IA,"Fremont, IA",59090,11,757,32443,26647,1.82
 2019,Fremont,WY,"Fremont, WY",46798,0,1068,45771,1027,1.02
 2020,Fremont,WY,"Fremont, WY",49268,5,1125,48214,1054,1.02
 2021,Fremont,WY,"Fremont, WY",51452,4,1526,65400,-13948,0.79
 2019,Fresno,CA,"Fresno, CA",42987,0,1452,62229,-19242,0.69
 2020,Fresno,CA,"Fresno, CA",48312,12,1583,67843,-19531,0.71
 2021,Fresno,CA,"Fresno, CA",51422,6,1950,83571,-32149,0.62
 2019,Frio,TX,"Frio, TX",33917,0,525,22500,11417,1.51
 2020,Frio,TX,"Frio, TX",35893,6,771,33043,2850,1.09
 2021,Frio,TX,"Frio, TX",39898,11,954,40886,-988,0.98
 2019,Frontier,NE,"Frontier, NE",39203,0,731,31329,7874,1.25
 2020,Frontier,NE,"Frontier, NE",47254,21,532,22800,24454,2.07
 2021,Frontier,NE,"Frontier, NE",55020,16,989,42386,12634,1.3
 2019,Fulton,AR,"Fulton, AR",29034,0,739,31671,-2637,0.92
 2020,Fulton,AR,"Fulton, AR",32621,12,700,30000,2621,1.09
 2021,Fulton,AR,"Fulton, AR",34900,7,936,40114,-5214,0.87
 2019,Fulton,GA,"Fulton, GA",95148,0,2002,85800,9348,1.11
 2020,Fulton,GA,"Fulton, GA",95825,1,1887,80871,14954,1.18
 2021,Fulton,GA,"Fulton, GA",102074,7,2068,88629,13445,1.15
 2019,Fulton,IL,"Fulton, IL",38671,0,375,16071,22600,2.41
 2020,Fulton,IL,"Fulton, IL",42623,10,371,15900,26723,2.68
 2021,Fulton,IL,"Fulton, IL",46395,9,343,14700,31695,3.16
 2019,Fulton,IN,"Fulton, IN",42021,0,647,27729,14292,1.52
 2020,Fulton,IN,"Fulton, IN",45545,8,640,27429,18116,1.66
 2021,Fulton,IN,"Fulton, IN",49205,8,772,33086,16119,1.49
 2019,Fulton,KY,"Fulton, KY",32318,0,263,11271,21047,2.87
 2020,Fulton,KY,"Fulton, KY",35844,11,335,14357,21487,2.5
 2021,Fulton,KY,"Fulton, KY",41650,16,427,18300,23350,2.28
 2019,Fulton,NY,"Fulton, NY",44191,0,711,30471,13720,1.45
 2020,Fulton,NY,"Fulton, NY",48587,10,683,29271,19316,1.66
 2021,Fulton,NY,"Fulton, NY",51558,6,944,40457,11101,1.27
 2019,Fulton,OH,"Fulton, OH",46220,0,628,26914,19306,1.72
 2020,Fulton,OH,"Fulton, OH",49896,8,718,30771,19125,1.62
 2021,Fulton,OH,"Fulton, OH",52995,6,837,35871,17124,1.48
 2019,Fulton,PA,"Fulton, PA",45295,0,830,35571,9724,1.27
 2020,Fulton,PA,"Fulton, PA",48242,7,873,37414,10828,1.29
 2021,Fulton,PA,"Fulton, PA",49929,4,1227,52586,-2657,0.95
 2019,Furnas,NE,"Furnas, NE",46142,0,422,18086,28056,2.55
 2020,Furnas,NE,"Furnas, NE",53829,17,431,18471,35358,2.91
 2021,Furnas,NE,"Furnas, NE",59961,11,574,24600,35361,2.44
 2019,Gadsden,FL,"Gadsden, FL",37238,0,867,37157,81,1
 2020,Gadsden,FL,"Gadsden, FL",40463,9,886,37971,2492,1.07
 2021,Gadsden,FL,"Gadsden, FL",44832,11,1002,42943,1889,1.04
 2019,Gage,NE,"Gage, NE",48682,0,650,27857,20825,1.75
 2020,Gage,NE,"Gage, NE",52502,8,688,29486,23016,1.78
 2021,Gage,NE,"Gage, NE",57838,10,731,31329,26509,1.85
 2019,Gaines,TX,"Gaines, TX",45865,0,877,37586,8279,1.22
 2020,Gaines,TX,"Gaines, TX",47535,4,927,39729,7806,1.2
 2021,Gaines,TX,"Gaines, TX",50616,7,1241,53186,-2570,0.95
 2019,Gallatin,IL,"Gallatin, IL",41067,0,255,10929,30138,3.76
 2020,Gallatin,IL,"Gallatin, IL",45909,12,541,23186,22723,1.98
 2021,Gallatin,IL,"Gallatin, IL",53962,18,460,19714,34248,2.74
 2019,Gallatin,KY,"Gallatin, KY",34869,0,906,38829,-3960,0.9
 2020,Gallatin,KY,"Gallatin, KY",38764,11,1055,45214,-6450,0.86
 2021,Gallatin,KY,"Gallatin, KY",42255,9,1187,50871,-8616,0.83
 2019,Gallatin,MT,"Gallatin, MT",60242,0,2552,109371,-49129,0.55
 2020,Gallatin,MT,"Gallatin, MT",65225,8,2901,124329,-59104,0.52
 2021,Gallatin,MT,"Gallatin, MT",70276,8,6177,264729,-194453,0.27
 2019,Gallia,OH,"Gallia, OH",41574,0,620,26571,15003,1.56
 2020,Gallia,OH,"Gallia, OH",44973,8,634,27171,17802,1.66
 2021,Gallia,OH,"Gallia, OH",47674,6,807,34586,13088,1.38
 2019,Galveston,TX,"Galveston, TX",55995,0,1410,60429,-4434,0.93
 2020,Galveston,TX,"Galveston, TX",57087,2,1431,61329,-4242,0.93
 2021,Galveston,TX,"Galveston, TX",60071,5,1460,62571,-2500,0.96
 2019,Garden,NE,"Garden, NE",47020,0,505,21643,25377,2.17
 2020,Garden,NE,"Garden, NE",51193,9,371,15900,35293,3.22
 2021,Garden,NE,"Garden, NE",57475,12,335,14357,43118,4
 2019,Garfield,CO,"Garfield, CO",59183,0,2820,120857,-61674,0.49
 2020,Garfield,CO,"Garfield, CO",62296,5,2622,112371,-50075,0.55
 2021,Garfield,CO,"Garfield, CO",67123,8,2795,119786,-52663,0.56
 2019,Garfield,MT,"Garfield, MT",35023,0,1159,49671,-14648,0.71
 2020,Garfield,MT,"Garfield, MT",41816,19,2021,86614,-44798,0.48
 2021,Garfield,MT,"Garfield, MT",37365,-11,1103,47271,-9906,0.79
 2019,Garfield,NE,"Garfield, NE",46130,0,0,0,46130,0
 2020,Garfield,NE,"Garfield, NE",54226,18,1005,43071,11155,1.26
 2021,Garfield,NE,"Garfield, NE",54771,1,755,32357,22414,1.69
 2019,Garfield,OK,"Garfield, OK",43701,0,810,34714,8987,1.26
 2020,Garfield,OK,"Garfield, OK",44850,3,771,33043,11807,1.36
 2021,Garfield,OK,"Garfield, OK",48861,9,776,33257,15604,1.47
 2019,Garfield,UT,"Garfield, UT",39440,0,1737,74443,-35003,0.53
 2020,Garfield,UT,"Garfield, UT",43010,9,1686,72257,-29247,0.6
 2021,Garfield,UT,"Garfield, UT",50209,17,2073,88843,-38634,0.57
 2019,Garfield,WA,"Garfield, WA",50341,0,800,34286,16055,1.47
 2020,Garfield,WA,"Garfield, WA",56479,12,759,32529,23950,1.74
 2021,Garfield,WA,"Garfield, WA",56792,1,1313,56271,521,1.01
 2019,Garrard,KY,"Garrard, KY",36992,0,1068,45771,-8779,0.81
 2020,Garrard,KY,"Garrard, KY",40329,9,993,42557,-2228,0.95
 2021,Garrard,KY,"Garrard, KY",43418,8,1382,59229,-15811,0.73
 2019,Garrett,MD,"Garrett, MD",46295,0,1467,62871,-16576,0.74
 2020,Garrett,MD,"Garrett, MD",49772,8,1632,69943,-20171,0.71
 2021,Garrett,MD,"Garrett, MD",53008,7,2354,100886,-47878,0.53
 2019,Garvin,OK,"Garvin, OK",43021,0,534,22886,20135,1.88
 2020,Garvin,OK,"Garvin, OK",46164,7,471,20186,25978,2.29
 2021,Garvin,OK,"Garvin, OK",48690,6,954,40886,7804,1.19
 2019,Garza,TX,"Garza, TX",33543,0,868,37200,-3657,0.9
 2020,Garza,TX,"Garza, TX",32829,-2,777,33300,-471,0.99
 2021,Garza,TX,"Garza, TX",36426,11,485,20786,15640,1.75
 2019,Gasconade,MO,"Gasconade, MO",40633,0,620,26571,14062,1.53
 2020,Gasconade,MO,"Gasconade, MO",43585,7,655,28071,15514,1.55
 2021,Gasconade,MO,"Gasconade, MO",45866,5,783,33557,12309,1.37
 2019,Gaston,NC,"Gaston, NC",41535,0,1112,47657,-6122,0.87
 2020,Gaston,NC,"Gaston, NC",44739,8,1163,49843,-5104,0.9
 2021,Gaston,NC,"Gaston, NC",48508,8,1316,56400,-7892,0.86
 2019,Gates,NC,"Gates, NC",42248,0,848,36343,5905,1.16
 2020,Gates,NC,"Gates, NC",45113,7,682,29229,15884,1.54
 2021,Gates,NC,"Gates, NC",50100,11,739,31671,18429,1.58
 2019,Geary,KS,"Geary, KS",46393,0,599,25671,20722,1.81
 2020,Geary,KS,"Geary, KS",48695,5,586,25114,23581,1.94
 2021,Geary,KS,"Geary, KS",52135,7,669,28671,23464,1.82
 2019,Geauga,OH,"Geauga, OH",71640,0,1747,74871,-3231,0.96
 2020,Geauga,OH,"Geauga, OH",74087,3,1826,78257,-4170,0.95
 2021,Geauga,OH,"Geauga, OH",78294,6,1635,70071,8223,1.12
 2019,Gem,ID,"Gem, ID",39541,0,1304,55886,-16345,0.71
 2020,Gem,ID,"Gem, ID",42252,7,2211,94757,-52505,0.45
 2021,Gem,ID,"Gem, ID",45441,8,2485,106500,-61059,0.43
 2019,Genesee,MI,"Genesee, MI",42141,0,717,30729,11412,1.37
 2020,Genesee,MI,"Genesee, MI",46371,10,824,35314,11057,1.31
 2021,Genesee,MI,"Genesee, MI",49399,7,865,37071,12328,1.33
 2019,Genesee,NY,"Genesee, NY",44444,0,469,20100,24344,2.21
 2020,Genesee,NY,"Genesee, NY",48351,9,702,30086,18265,1.61
 2021,Genesee,NY,"Genesee, NY",50662,5,857,36729,13933,1.38
 2019,Geneva,AL,"Geneva, AL",36154,0,554,23743,12411,1.52
 2020,Geneva,AL,"Geneva, AL",38132,6,695,29786,8346,1.28
 2021,Geneva,AL,"Geneva, AL",41569,9,863,36986,4583,1.12
 2019,Gentry,MO,"Gentry, MO",45703,0,512,21943,23760,2.08
 2020,Gentry,MO,"Gentry, MO",49591,9,433,18557,31034,2.67
 2021,Gentry,MO,"Gentry, MO",50953,3,759,32529,18424,1.57
 2019,George,MS,"George, MS",34072,0,741,31757,2315,1.07
 2020,George,MS,"George, MS",38208,12,780,33429,4779,1.14
 2021,George,MS,"George, MS",39807,4,953,40843,-1036,0.97
 2019,Georgetown,SC,"Georgetown, SC",50433,0,1843,78986,-28553,0.64
 2020,Georgetown,SC,"Georgetown, SC",53677,6,1838,78771,-25094,0.68
 2021,Georgetown,SC,"Georgetown, SC",57656,7,1842,78943,-21287,0.73
 2019,Gibson,IN,"Gibson, IN",46659,0,532,22800,23859,2.05
 2020,Gibson,IN,"Gibson, IN",50211,8,502,21514,28697,2.33
 2021,Gibson,IN,"Gibson, IN",53562,7,707,30300,23262,1.77
 2019,Gibson,TN,"Gibson, TN",39164,0,589,25243,13921,1.55
 2020,Gibson,TN,"Gibson, TN",42264,8,564,24171,18093,1.75
 2021,Gibson,TN,"Gibson, TN",46449,10,672,28800,17649,1.61
 2019,Gila,AZ,"Gila, AZ",41033,0,1662,71229,-30196,0.58
 2020,Gila,AZ,"Gila, AZ",45429,11,1639,70243,-24814,0.65
 2021,Gila,AZ,"Gila, AZ",48752,7,2138,91629,-42877,0.53
 2019,Gilchrist,FL,"Gilchrist, FL",36618,0,1179,50529,-13911,0.72
 2020,Gilchrist,FL,"Gilchrist, FL",39046,7,1271,54471,-15425,0.72
 2021,Gilchrist,FL,"Gilchrist, FL",41769,7,1772,75943,-34174,0.55
 2019,Giles,TN,"Giles, TN",38464,0,821,35186,3278,1.09
 2020,Giles,TN,"Giles, TN",40755,6,975,41786,-1031,0.98
 2021,Giles,TN,"Giles, TN",43321,6,1522,65229,-21908,0.66
 2019,Giles,VA,"Giles, VA",40611,0,735,31500,9111,1.29
 2020,Giles,VA,"Giles, VA",43685,8,567,24300,19385,1.8
 2021,Giles,VA,"Giles, VA",48098,10,730,31286,16812,1.54
 2019,Gillespie,TX,"Gillespie, TX",69396,0,2556,109543,-40147,0.63
 2020,Gillespie,TX,"Gillespie, TX",73481,6,2681,114900,-41419,0.64
 2021,Gillespie,TX,"Gillespie, TX",78039,6,4262,182657,-104618,0.43
 2019,Gilliam,OR,"Gilliam, OR",55635,0,507,21729,33906,2.56
 2020,Gilliam,OR,"Gilliam, OR",64369,16,1182,50657,13712,1.27
 2021,Gilliam,OR,"Gilliam, OR",63645,-1,1430,61286,2359,1.04
 2019,Gilmer,GA,"Gilmer, GA",37263,0,1242,53229,-15966,0.7
 2020,Gilmer,GA,"Gilmer, GA",38886,4,1562,66943,-28057,0.58
 2021,Gilmer,GA,"Gilmer, GA",42351,9,2255,96643,-54292,0.44
 2019,Gilmer,WV,"Gilmer, WV",31784,0,616,26400,5384,1.2
 2020,Gilmer,WV,"Gilmer, WV",33344,5,472,20229,13115,1.65
 2021,Gilmer,WV,"Gilmer, WV",35405,6,632,27086,8319,1.31
 2019,Gilpin,CO,"Gilpin, CO",53743,0,2496,106971,-53228,0.5
 2020,Gilpin,CO,"Gilpin, CO",59027,10,2731,117043,-58016,0.5
 2021,Gilpin,CO,"Gilpin, CO",63971,8,3097,132729,-68758,0.48
 2019,Glacier,MT,"Glacier, MT",37046,0,563,24129,12917,1.54
 2020,Glacier,MT,"Glacier, MT",41271,11,513,21986,19285,1.88
 2021,Glacier,MT,"Glacier, MT",41159,0,1609,68957,-27798,0.6
 2019,Glades,FL,"Glades, FL",28683,0,909,38957,-10274,0.74
 2020,Glades,FL,"Glades, FL",31398,10,876,37543,-6145,0.84
 2021,Glades,FL,"Glades, FL",33401,6,844,36171,-2770,0.92
 2019,Gladwin,MI,"Gladwin, MI",38377,0,634,27171,11206,1.41
 2020,Gladwin,MI,"Gladwin, MI",41637,9,676,28971,12666,1.44
 2021,Gladwin,MI,"Gladwin, MI",44068,6,858,36771,7297,1.2
 2019,Glascock,GA,"Glascock, GA",35630,0,161,6900,28730,5.16
 2020,Glascock,GA,"Glascock, GA",38061,7,1089,46671,-8610,0.82
 2021,Glascock,GA,"Glascock, GA",42716,12,4262,182657,-139941,0.23
 2019,Glasscock,TX,"Glasscock, TX",116639,0,983,42129,74510,2.77
 2020,Glasscock,TX,"Glasscock, TX",110206,-6,1295,55500,54706,1.99
 2021,Glasscock,TX,"Glasscock, TX",124963,13,1542,66086,58877,1.89
 2019,Glenn,CA,"Glenn, CA",43581,0,1526,65400,-21819,0.67
 2020,Glenn,CA,"Glenn, CA",49454,14,1879,80529,-31075,0.61
 2021,Glenn,CA,"Glenn, CA",50626,2,1933,82843,-32217,0.61
 2019,Gloucester,NJ,"Gloucester, NJ",55704,0,965,41357,14347,1.35
 2020,Gloucester,NJ,"Gloucester, NJ",58909,6,1040,44571,14338,1.32
 2021,Gloucester,NJ,"Gloucester, NJ",62553,6,1305,55929,6624,1.12
 2019,Gloucester,VA,"Gloucester, VA",49305,0,1337,57300,-7995,0.86
 2020,Gloucester,VA,"Gloucester, VA",52410,6,1419,60814,-8404,0.86
 2021,Gloucester,VA,"Gloucester, VA",55944,7,1538,65914,-9970,0.85
 2019,Glynn,GA,"Glynn, GA",48693,0,1809,77529,-28836,0.63
 2020,Glynn,GA,"Glynn, GA",52149,7,1921,82329,-30180,0.63
 2021,Glynn,GA,"Glynn, GA",55351,6,1709,73243,-17892,0.76
 2019,Gogebic,MI,"Gogebic, MI",42173,0,661,28329,13844,1.49
 2020,Gogebic,MI,"Gogebic, MI",46469,10,730,31286,15183,1.49
 2021,Gogebic,MI,"Gogebic, MI",48705,5,1443,61843,-13138,0.79
 2019,Golden Valley,MT,"Golden Valley, MT",49935,0,405,17357,32578,2.88
 2020,Golden Valley,MT,"Golden Valley, MT",53351,7,787,33729,19622,1.58
 2021,Golden Valley,MT,"Golden Valley, MT",53046,-1,587,25157,27889,2.11
 2019,Golden Valley,ND,"Golden Valley, ND",39094,0,412,17657,21437,2.21
 2020,Golden Valley,ND,"Golden Valley, ND",44263,13,434,18600,25663,2.38
 2021,Golden Valley,ND,"Golden Valley, ND",52279,18,334,14314,37965,3.65
 2019,Goliad,TX,"Goliad, TX",51154,0,1351,57900,-6746,0.88
 2020,Goliad,TX,"Goliad, TX",52404,2,1486,63686,-11282,0.82
 2021,Goliad,TX,"Goliad, TX",55947,7,1776,76114,-20167,0.74
 2019,Gonzales,TX,"Gonzales, TX",48605,0,1060,45429,3176,1.07
 2020,Gonzales,TX,"Gonzales, TX",49879,3,1441,61757,-11878,0.81
 2021,Gonzales,TX,"Gonzales, TX",57578,15,1318,56486,1092,1.02
 2019,Goodhue,MN,"Goodhue, MN",54665,0,1313,56271,-1606,0.97
 2020,Goodhue,MN,"Goodhue, MN",57401,5,1242,53229,4172,1.08
 2021,Goodhue,MN,"Goodhue, MN",60933,6,1412,60514,419,1.01
 2019,Gooding,ID,"Gooding, ID",59278,0,914,39171,20107,1.51
 2020,Gooding,ID,"Gooding, ID",63489,7,1001,42900,20589,1.48
 2021,Gooding,ID,"Gooding, ID",63847,1,1384,59314,4533,1.08
 2019,Gordon,GA,"Gordon, GA",36576,0,838,35914,662,1.02
 2020,Gordon,GA,"Gordon, GA",38445,5,912,39086,-641,0.98
 2021,Gordon,GA,"Gordon, GA",42281,10,1293,55414,-13133,0.76
 2019,Goshen,WY,"Goshen, WY",45141,0,830,35571,9570,1.27
 2020,Goshen,WY,"Goshen, WY",47900,6,812,34800,13100,1.38
 2021,Goshen,WY,"Goshen, WY",50633,6,1005,43071,7562,1.18
 2019,Gosper,NE,"Gosper, NE",52047,0,1400,60000,-7953,0.87
 2020,Gosper,NE,"Gosper, NE",60103,16,1367,58586,1517,1.03
 2021,Gosper,NE,"Gosper, NE",67627,13,1182,50657,16970,1.33
 2019,Gove,KS,"Gove, KS",55480,0,637,27300,28180,2.03
 2020,Gove,KS,"Gove, KS",63850,15,1112,47657,16193,1.34
 2021,Gove,KS,"Gove, KS",69011,8,393,16843,52168,4.1
 2019,Grady,GA,"Grady, GA",33245,0,778,33343,-98,1
 2020,Grady,GA,"Grady, GA",35214,6,1021,43757,-8543,0.8
 2021,Grady,GA,"Grady, GA",39020,11,1172,50229,-11209,0.78
 2019,Grady,OK,"Grady, OK",42770,0,798,34200,8570,1.25
 2020,Grady,OK,"Grady, OK",44915,5,974,41743,3172,1.08
 2021,Grady,OK,"Grady, OK",47840,7,1102,47229,611,1.01
 2019,Grafton,NH,"Grafton, NH",66344,0,1189,50957,15387,1.3
 2020,Grafton,NH,"Grafton, NH",70687,7,1254,53743,16944,1.32
 2021,Grafton,NH,"Grafton, NH",74813,6,1670,71571,3242,1.05
 2019,Graham,AZ,"Graham, AZ",32018,0,856,36686,-4668,0.87
 2020,Graham,AZ,"Graham, AZ",35987,12,1016,43543,-7556,0.83
 2021,Graham,AZ,"Graham, AZ",38785,8,1368,58629,-19844,0.66
 2019,Graham,KS,"Graham, KS",49894,0,315,13500,36394,3.7
 2020,Graham,KS,"Graham, KS",55636,12,359,15386,40250,3.62
 2021,Graham,KS,"Graham, KS",62383,12,337,14443,47940,4.32
 2019,Graham,NC,"Graham, NC",37164,0,1375,58929,-21765,0.63
 2020,Graham,NC,"Graham, NC",39698,7,1193,51129,-11431,0.78
 2021,Graham,NC,"Graham, NC",43178,9,2104,90171,-46993,0.48
 2019,Grainger,TN,"Grainger, TN",35331,0,1006,43114,-7783,0.82
 2020,Grainger,TN,"Grainger, TN",38242,8,1169,50100,-11858,0.76
 2021,Grainger,TN,"Grainger, TN",41569,9,1401,60043,-18474,0.69
 2019,Granite,MT,"Granite, MT",46221,0,1942,83229,-37008,0.56
 2020,Granite,MT,"Granite, MT",49622,7,1907,81729,-32107,0.61
 2021,Granite,MT,"Granite, MT",51995,5,2778,119057,-67062,0.44
 2019,Grant,AR,"Grant, AR",40384,0,713,30557,9827,1.32
 2020,Grant,AR,"Grant, AR",43237,7,701,30043,13194,1.44
 2021,Grant,AR,"Grant, AR",46161,7,867,37157,9004,1.24
 2019,Grant,IN,"Grant, IN",39179,0,331,14186,24993,2.76
 2020,Grant,IN,"Grant, IN",42730,9,388,16629,26101,2.57
 2021,Grant,IN,"Grant, IN",46892,10,400,17143,29749,2.74
 2019,Grant,KS,"Grant, KS",41606,0,674,28886,12720,1.44
 2020,Grant,KS,"Grant, KS",43389,4,767,32871,10518,1.32
 2021,Grant,KS,"Grant, KS",43192,-1,780,33429,9763,1.29
 2019,Grant,KY,"Grant, KY",38185,0,1119,47957,-9772,0.8
 2020,Grant,KY,"Grant, KY",41934,10,1085,46500,-4566,0.9
 2021,Grant,KY,"Grant, KY",45039,7,1379,59100,-14061,0.76
 2019,Grant,LA,"Grant, LA",32122,0,814,34886,-2764,0.92
 2020,Grant,LA,"Grant, LA",35264,10,788,33771,1493,1.04
 2021,Grant,LA,"Grant, LA",37764,7,773,33129,4635,1.14
 2019,Grant,MN,"Grant, MN",45510,0,571,24471,21039,1.86
 2020,Grant,MN,"Grant, MN",53681,18,568,24343,29338,2.21
 2021,Grant,MN,"Grant, MN",57261,7,768,32914,24347,1.74
 2019,Grant,ND,"Grant, ND",43268,0,697,29871,13397,1.45
 2020,Grant,ND,"Grant, ND",54801,27,775,33214,21587,1.65
 2021,Grant,ND,"Grant, ND",57313,5,609,26100,31213,2.2
 2019,Grant,NE,"Grant, NE",50847,0,1775,76071,-25224,0.67
 2020,Grant,NE,"Grant, NE",56159,10,1031,44186,11973,1.27
 2021,Grant,NE,"Grant, NE",59952,7,1847,79157,-19205,0.76
 2019,Grant,NM,"Grant, NM",41531,0,1010,43286,-1755,0.96
 2020,Grant,NM,"Grant, NM",44295,7,982,42086,2209,1.05
 2021,Grant,NM,"Grant, NM",48537,10,1399,59957,-11420,0.81
 2019,Grant,OK,"Grant, OK",49106,0,439,18814,30292,2.61
 2020,Grant,OK,"Grant, OK",54509,11,377,16157,38352,3.37
 2021,Grant,OK,"Grant, OK",60177,10,322,13800,46377,4.36
 2019,Grant,OR,"Grant, OR",42841,0,1086,46543,-3702,0.92
 2020,Grant,OR,"Grant, OR",47602,11,1169,50100,-2498,0.95
 2021,Grant,OR,"Grant, OR",50870,7,1202,51514,-644,0.99
 2019,Grant,SD,"Grant, SD",51119,0,569,24386,26733,2.1
 2020,Grant,SD,"Grant, SD",58307,14,1093,46843,11464,1.24
 2021,Grant,SD,"Grant, SD",63935,10,622,26657,37278,2.4
 2019,Grant,WA,"Grant, WA",40839,0,1206,51686,-10847,0.79
 2020,Grant,WA,"Grant, WA",46331,13,1331,57043,-10712,0.81
 2021,Grant,WA,"Grant, WA",48845,5,1748,74914,-26069,0.65
 2019,Grant,WI,"Grant, WI",44992,0,710,30429,14563,1.48
 2020,Grant,WI,"Grant, WI",48773,8,801,34329,14444,1.42
 2021,Grant,WI,"Grant, WI",51761,6,855,36643,15118,1.41
 2019,Grant,WV,"Grant, WV",39374,0,949,40671,-1297,0.97
 2020,Grant,WV,"Grant, WV",42713,9,773,33129,9584,1.29
 2021,Grant,WV,"Grant, WV",45643,7,1106,47400,-1757,0.96
 2019,Granville,NC,"Granville, NC",40074,0,1418,60771,-20697,0.66
 2020,Granville,NC,"Granville, NC",43069,8,1357,58157,-15088,0.74
 2021,Granville,NC,"Granville, NC",46504,8,1576,67543,-21039,0.69
 2019,Gratiot,MI,"Gratiot, MI",36244,0,425,18214,18030,1.99
 2020,Gratiot,MI,"Gratiot, MI",40793,13,560,24000,16793,1.7
 2021,Gratiot,MI,"Gratiot, MI",43249,6,639,27386,15863,1.58
 2019,Graves,KY,"Graves, KY",39257,0,614,26314,12943,1.49
 2020,Graves,KY,"Graves, KY",42632,9,684,29314,13318,1.45
 2021,Graves,KY,"Graves, KY",47933,12,843,36129,11804,1.33
 2019,Gray,KS,"Gray, KS",59155,0,724,31029,28126,1.91
 2020,Gray,KS,"Gray, KS",64323,9,810,34714,29609,1.85
 2021,Gray,KS,"Gray, KS",64859,1,913,39129,25730,1.66
 2019,Gray,TX,"Gray, TX",44949,0,561,24043,20906,1.87
 2020,Gray,TX,"Gray, TX",46632,4,499,21386,25246,2.18
 2021,Gray,TX,"Gray, TX",49815,7,637,27300,22515,1.82
 2019,Grays Harbor,WA,"Grays Harbor, WA",40717,0,1112,47657,-6940,0.85
 2020,Grays Harbor,WA,"Grays Harbor, WA",44125,8,1184,50743,-6618,0.87
 2021,Grays Harbor,WA,"Grays Harbor, WA",47094,7,1373,58843,-11749,0.8
 2019,Grayson,KY,"Grayson, KY",35283,0,717,30729,4554,1.15
 2020,Grayson,KY,"Grayson, KY",39577,12,782,33514,6063,1.18
 2021,Grayson,KY,"Grayson, KY",42043,6,1107,47443,-5400,0.89
 2019,Grayson,TX,"Grayson, TX",45771,0,1155,49500,-3729,0.92
 2020,Grayson,TX,"Grayson, TX",48260,5,1174,50314,-2054,0.96
 2021,Grayson,TX,"Grayson, TX",52055,8,1704,73029,-20974,0.71
 2019,Grayson,VA,"Grayson, VA",32497,0,959,41100,-8603,0.79
 2020,Grayson,VA,"Grayson, VA",35407,9,841,36043,-636,0.98
 2021,Grayson,VA,"Grayson, VA",38600,9,1103,47271,-8671,0.82
 2019,Greeley,KS,"Greeley, KS",60821,0,325,13929,46892,4.37
 2021,Greeley,KS,"Greeley, KS",93667,12,473,20271,73396,4.62
 2020,Greeley,NE,"Greeley, NE",59544,16,983,42129,17415,1.41
 2021,Greeley,NE,"Greeley, NE",66840,12,983,42129,24711,1.59
 2019,Green Lake,WI,"Green Lake, WI",44772,0,1271,54471,-9699,0.82
 2020,Green Lake,WI,"Green Lake, WI",47046,5,1373,58843,-11797,0.8
 2021,Green Lake,WI,"Green Lake, WI",49311,5,1280,54857,-5546,0.9
 2019,Green,KY,"Green, KY",35209,0,518,22200,13009,1.59
 2020,Green,KY,"Green, KY",39385,12,495,21214,18171,1.86
 2021,Green,KY,"Green, KY",42768,9,952,40800,1968,1.05
 2019,Green,WI,"Green, WI",52723,0,1251,53614,-891,0.98
 2020,Green,WI,"Green, WI",56263,7,1127,48300,7963,1.16
 2021,Green,WI,"Green, WI",60240,7,1352,57943,2297,1.04
 2019,Greenbrier,WV,"Greenbrier, WV",41459,0,982,42086,-627,0.99
 2020,Greenbrier,WV,"Greenbrier, WV",44179,7,996,42686,1493,1.03
 2021,Greenbrier,WV,"Greenbrier, WV",47283,7,1018,43629,3654,1.08
 2019,Greene,AL,"Greene, AL",33294,0,440,18857,14437,1.77
 2020,Greene,AL,"Greene, AL",36851,11,427,18300,18551,2.01
 2021,Greene,AL,"Greene, AL",40461,10,839,35957,4504,1.13
 2019,Greene,AR,"Greene, AR",35811,0,735,31500,4311,1.14
 2020,Greene,AR,"Greene, AR",39258,10,804,34457,4801,1.14
 2021,Greene,AR,"Greene, AR",41633,6,636,27257,14376,1.53
 2019,Greene,GA,"Greene, GA",62615,0,2699,115671,-53056,0.54
 2020,Greene,GA,"Greene, GA",63335,1,2895,124071,-60736,0.51
 2021,Greene,GA,"Greene, GA",67417,6,3873,165986,-98569,0.41
 2019,Greene,IA,"Greene, IA",48302,0,358,15343,32959,3.15
 2020,Greene,IA,"Greene, IA",52189,8,482,20657,31532,2.53
 2021,Greene,IA,"Greene, IA",58799,13,595,25500,33299,2.31
 2019,Greene,IL,"Greene, IL",38757,0,343,14700,24057,2.64
 2020,Greene,IL,"Greene, IL",44275,14,296,12686,31589,3.49
 2021,Greene,IL,"Greene, IL",51356,16,303,12986,38370,3.95
 2019,Greene,IN,"Greene, IN",42766,0,430,18429,24337,2.32
 2020,Greene,IN,"Greene, IN",46273,8,609,26100,20173,1.77
 2021,Greene,IN,"Greene, IN",50131,8,676,28971,21160,1.73
 2019,Greene,MO,"Greene, MO",45900,0,879,37671,8229,1.22
 2020,Greene,MO,"Greene, MO",48134,5,958,41057,7077,1.17
 2021,Greene,MO,"Greene, MO",51220,6,1331,57043,-5823,0.9
 2019,Greene,MS,"Greene, MS",28265,0,633,27129,1136,1.04
 2020,Greene,MS,"Greene, MS",30485,8,738,31629,-1144,0.96
 2021,Greene,MS,"Greene, MS",33133,9,801,34329,-1196,0.97
 2019,Greene,NC,"Greene, NC",32922,0,501,21471,11451,1.53
 2020,Greene,NC,"Greene, NC",35457,8,609,26100,9357,1.36
 2021,Greene,NC,"Greene, NC",39564,12,704,30171,9393,1.31
 2019,Greene,NY,"Greene, NY",48849,0,1290,55286,-6437,0.88
 2020,Greene,NY,"Greene, NY",53044,9,1396,59829,-6785,0.89
 2021,Greene,NY,"Greene, NY",55805,5,1866,79971,-24166,0.7
 2019,Greene,OH,"Greene, OH",52189,0,1001,42900,9289,1.22
 2020,Greene,OH,"Greene, OH",55300,6,1199,51386,3914,1.08
 2021,Greene,OH,"Greene, OH",58363,6,1317,56443,1920,1.03
 2019,Greene,PA,"Greene, PA",44620,0,678,29057,15563,1.54
 2020,Greene,PA,"Greene, PA",47846,7,709,30386,17460,1.57
 2021,Greene,PA,"Greene, PA",50266,5,790,33857,16409,1.48
 2019,Greene,TN,"Greene, TN",37107,0,824,35314,1793,1.05
 2020,Greene,TN,"Greene, TN",39047,5,992,42514,-3467,0.92
 2021,Greene,TN,"Greene, TN",41796,7,1262,54086,-12290,0.77
 2019,Greene,VA,"Greene, VA",45027,0,1522,65229,-20202,0.69
 2020,Greene,VA,"Greene, VA",47440,5,1693,72557,-25117,0.65
 2021,Greene,VA,"Greene, VA",51152,8,2128,91200,-40048,0.56
 2019,Greenlee,AZ,"Greenlee, AZ",40517,0,928,39771,746,1.02
 2020,Greenlee,AZ,"Greenlee, AZ",43150,7,1132,48514,-5364,0.89
 2021,Greenlee,AZ,"Greenlee, AZ",48079,11,1055,45214,2865,1.06
 2019,Greenup,KY,"Greenup, KY",40705,0,632,27086,13619,1.5
 2020,Greenup,KY,"Greenup, KY",44283,9,745,31929,12354,1.39
 2021,Greenup,KY,"Greenup, KY",47675,8,786,33686,13989,1.42
 2019,Greenville,SC,"Greenville, SC",50680,0,1381,59186,-8506,0.86
 2020,Greenville,SC,"Greenville, SC",52376,3,1413,60557,-8181,0.86
 2021,Greenville,SC,"Greenville, SC",55442,6,1879,80529,-25087,0.69
 2019,Greenwood,KS,"Greenwood, KS",41624,0,337,14443,27181,2.88
 2020,Greenwood,KS,"Greenwood, KS",46373,11,451,19329,27044,2.4
 2021,Greenwood,KS,"Greenwood, KS",49675,7,420,18000,31675,2.76
 2019,Greenwood,SC,"Greenwood, SC",38712,0,1068,45771,-7059,0.85
 2020,Greenwood,SC,"Greenwood, SC",41762,8,1322,56657,-14895,0.74
 2021,Greenwood,SC,"Greenwood, SC",44723,7,1217,52157,-7434,0.86
 2019,Greer,OK,"Greer, OK",30780,0,341,14614,16166,2.11
 2020,Greer,OK,"Greer, OK",33100,8,211,9043,24057,3.66
 2021,Greer,OK,"Greer, OK",35502,7,417,17871,17631,1.99
 2019,Gregg,TX,"Gregg, TX",47616,0,931,39900,7716,1.19
 2020,Gregg,TX,"Gregg, TX",49827,5,984,42171,7656,1.18
 2021,Gregg,TX,"Gregg, TX",52958,6,1304,55886,-2928,0.95
 2019,Gregory,SD,"Gregory, SD",46928,0,196,8400,38528,5.59
 2020,Gregory,SD,"Gregory, SD",53369,14,623,26700,26669,2
 2021,Gregory,SD,"Gregory, SD",57305,7,838,35914,21391,1.6
 2019,Grenada,MS,"Grenada, MS",35452,0,590,25286,10166,1.4
 2020,Grenada,MS,"Grenada, MS",38553,9,769,32957,5596,1.17
 2021,Grenada,MS,"Grenada, MS",41935,9,943,40414,1521,1.04
 2019,Griggs,ND,"Griggs, ND",55402,0,694,29743,25659,1.86
 2020,Griggs,ND,"Griggs, ND",68358,23,264,11314,57044,6.04
 2021,Griggs,ND,"Griggs, ND",73012,7,408,17486,55526,4.18
 2019,Grimes,TX,"Grimes, TX",37881,0,942,40371,-2490,0.94
 2020,Grimes,TX,"Grimes, TX",39626,5,991,42471,-2845,0.93
 2021,Grimes,TX,"Grimes, TX",41914,6,1776,76114,-34200,0.55
 2019,Grundy,IA,"Grundy, IA",51873,0,660,28286,23587,1.83
 2020,Grundy,IA,"Grundy, IA",55698,7,621,26614,29084,2.09
 2021,Grundy,IA,"Grundy, IA",62531,12,842,36086,26445,1.73
 2019,Grundy,IL,"Grundy, IL",58763,0,1221,52329,6434,1.12
 2020,Grundy,IL,"Grundy, IL",59913,2,1212,51943,7970,1.15
 2021,Grundy,IL,"Grundy, IL",65839,10,1188,50914,14925,1.29
 2019,Grundy,MO,"Grundy, MO",34882,0,315,13500,21382,2.58
 2020,Grundy,MO,"Grundy, MO",38424,10,413,17700,20724,2.17
 2021,Grundy,MO,"Grundy, MO",40504,5,411,17614,22890,2.3
 2019,Grundy,TN,"Grundy, TN",33628,0,991,42471,-8843,0.79
 2020,Grundy,TN,"Grundy, TN",36609,9,1187,50871,-14262,0.72
 2021,Grundy,TN,"Grundy, TN",39349,8,1473,63129,-23780,0.62
 2019,Guadalupe,NM,"Guadalupe, NM",33980,0,719,30814,3166,1.1
 2020,Guadalupe,NM,"Guadalupe, NM",37162,9,602,25800,11362,1.44
 2021,Guadalupe,NM,"Guadalupe, NM",43255,16,815,34929,8326,1.24
 2019,Guadalupe,TX,"Guadalupe, TX",47156,0,1318,56486,-9330,0.83
 2020,Guadalupe,TX,"Guadalupe, TX",49296,5,1302,55800,-6504,0.88
 2021,Guadalupe,TX,"Guadalupe, TX",52190,6,1666,71400,-19210,0.73
 2019,Guernsey,OH,"Guernsey, OH",41970,0,644,27600,14370,1.52
 2020,Guernsey,OH,"Guernsey, OH",45838,9,642,27514,18324,1.67
 2021,Guernsey,OH,"Guernsey, OH",48667,6,833,35700,12967,1.36
 2019,Guilford,NC,"Guilford, NC",47340,0,1383,59271,-11931,0.8
 2020,Guilford,NC,"Guilford, NC",50418,7,1442,61800,-11382,0.82
 2021,Guilford,NC,"Guilford, NC",54651,8,1394,59743,-5092,0.91
 2019,Gulf,FL,"Gulf, FL",43025,0,1771,75900,-32875,0.57
 2020,Gulf,FL,"Gulf, FL",45709,6,1879,80529,-34820,0.57
 2021,Gulf,FL,"Gulf, FL",49250,8,1986,85114,-35864,0.58
 2019,Gunnison,CO,"Gunnison, CO",51935,0,3257,139586,-87651,0.37
 2020,Gunnison,CO,"Gunnison, CO",56168,8,2617,112157,-55989,0.5
 2021,Gunnison,CO,"Gunnison, CO",59514,6,5515,236357,-176843,0.25
 2019,Guthrie,IA,"Guthrie, IA",52384,0,828,35486,16898,1.48
 2020,Guthrie,IA,"Guthrie, IA",57366,10,794,34029,23337,1.69
 2021,Guthrie,IA,"Guthrie, IA",63098,10,830,35571,27527,1.77
 2019,Gwinnett,GA,"Gwinnett, GA",43158,0,1555,66643,-23485,0.65
 2020,Gwinnett,GA,"Gwinnett, GA",46705,8,1537,65871,-19166,0.71
 2021,Gwinnett,GA,"Gwinnett, GA",50256,8,1912,81943,-31687,0.61
 2019,Haakon,SD,"Haakon, SD",47567,0,718,30771,16796,1.55
 2020,Haakon,SD,"Haakon, SD",68305,44,502,21514,46791,3.17
 2021,Haakon,SD,"Haakon, SD",74530,9,1199,51386,23144,1.45
 2019,Habersham,GA,"Habersham, GA",35211,0,1312,56229,-21018,0.63
 2020,Habersham,GA,"Habersham, GA",36989,5,1392,59657,-22668,0.62
 2021,Habersham,GA,"Habersham, GA",39304,6,1518,65057,-25753,0.6
 2019,Haines,AK,"Haines, AK",86528,0,1118,47914,38614,1.81
 2020,Haines,AK,"Haines, AK",81888,-5,1246,53400,28488,1.53
 2021,Haines,AK,"Haines, AK",88152,8,1653,70843,17309,1.24
 2019,Hale,AL,"Hale, AL",37619,0,735,31500,6119,1.19
 2020,Hale,AL,"Hale, AL",40633,8,701,30043,10590,1.35
 2021,Hale,AL,"Hale, AL",44085,9,910,39000,5085,1.13
 2019,Hale,TX,"Hale, TX",36347,0,622,26657,9690,1.36
 2020,Hale,TX,"Hale, TX",39454,9,641,27471,11983,1.44
 2021,Hale,TX,"Hale, TX",43543,10,663,28414,15129,1.53
 2019,Halifax,NC,"Halifax, NC",37975,0,593,25414,12561,1.49
 2020,Halifax,NC,"Halifax, NC",40677,7,736,31543,9134,1.29
 2021,Halifax,NC,"Halifax, NC",44948,11,794,34029,10919,1.32
 2019,Halifax,VA,"Halifax, VA",36761,0,647,27729,9032,1.33
 2020,Halifax,VA,"Halifax, VA",39923,9,570,24429,15494,1.63
 2021,Halifax,VA,"Halifax, VA",43557,9,884,37886,5671,1.15
 2019,Hall,GA,"Hall, GA",47263,0,1626,69686,-22423,0.68
 2020,Hall,GA,"Hall, GA",49925,6,1577,67586,-17661,0.74
 2021,Hall,GA,"Hall, GA",53920,8,2217,95014,-41094,0.57
 2019,Hall,NE,"Hall, NE",43633,0,872,37371,6262,1.17
 2020,Hall,NE,"Hall, NE",47179,8,1041,44614,2565,1.06
 2021,Hall,NE,"Hall, NE",51566,9,1020,43714,7852,1.18
 2019,Hall,TX,"Hall, TX",34368,0,292,12514,21854,2.75
 2020,Hall,TX,"Hall, TX",38506,12,219,9386,29120,4.1
 2021,Hall,TX,"Hall, TX",48706,27,419,17957,30749,2.71
 2019,Hamblen,TN,"Hamblen, TN",38554,0,853,36557,1997,1.05
 2020,Hamblen,TN,"Hamblen, TN",41810,8,949,40671,1139,1.03
 2021,Hamblen,TN,"Hamblen, TN",45234,8,1300,55714,-10480,0.81
 2019,Hamilton,FL,"Hamilton, FL",27604,0,881,37757,-10153,0.73
 2020,Hamilton,FL,"Hamilton, FL",29767,8,1074,46029,-16262,0.65
 2021,Hamilton,FL,"Hamilton, FL",32123,8,1199,51386,-19263,0.63
 2019,Hamilton,IA,"Hamilton, IA",51007,0,599,25671,25336,1.99
 2020,Hamilton,IA,"Hamilton, IA",50276,-1,615,26357,23919,1.91
 2021,Hamilton,IA,"Hamilton, IA",58126,16,589,25243,32883,2.3
 2019,Hamilton,IL,"Hamilton, IL",43440,0,400,17143,26297,2.53
 2020,Hamilton,IL,"Hamilton, IL",48156,11,419,17957,30199,2.68
 2021,Hamilton,IL,"Hamilton, IL",53814,12,715,30643,23171,1.76
 2019,Hamilton,IN,"Hamilton, IN",78231,0,1842,78943,-712,0.99
 2020,Hamilton,IN,"Hamilton, IN",81233,4,1845,79071,2162,1.03
 2021,Hamilton,IN,"Hamilton, IN",85814,6,2019,86529,-715,0.99
 2019,Hamilton,KS,"Hamilton, KS",53795,0,331,14186,39609,3.79
 2020,Hamilton,KS,"Hamilton, KS",72299,34,553,23700,48599,3.05
 2021,Hamilton,KS,"Hamilton, KS",71468,-1,635,27214,44254,2.63
 2019,Hamilton,NE,"Hamilton, NE",53781,0,930,39857,13924,1.35
 2020,Hamilton,NE,"Hamilton, NE",60279,12,970,41571,18708,1.45
 2021,Hamilton,NE,"Hamilton, NE",65739,9,1154,49457,16282,1.33
 2019,Hamilton,NY,"Hamilton, NY",49017,0,1312,56229,-7212,0.87
 2020,Hamilton,NY,"Hamilton, NY",52685,8,1249,53529,-844,0.98
 2021,Hamilton,NY,"Hamilton, NY",54556,4,1476,63257,-8701,0.86
 2019,Hamilton,OH,"Hamilton, OH",60698,0,1228,52629,8069,1.15
 2020,Hamilton,OH,"Hamilton, OH",64043,6,1422,60943,3100,1.05
 2021,Hamilton,OH,"Hamilton, OH",67845,6,1388,59486,8359,1.14
 2019,Hamilton,TN,"Hamilton, TN",54475,0,1455,62357,-7882,0.87
 2020,Hamilton,TN,"Hamilton, TN",56545,4,1567,67157,-10612,0.84
 2021,Hamilton,TN,"Hamilton, TN",60089,6,1878,80486,-20397,0.75
 2019,Hamilton,TX,"Hamilton, TX",68903,0,575,24643,44260,2.8
 2020,Hamilton,TX,"Hamilton, TX",72264,5,637,27300,44964,2.65
 2021,Hamilton,TX,"Hamilton, TX",77672,8,943,40414,37258,1.92
 2019,Hamlin,SD,"Hamlin, SD",44375,0,810,34714,9661,1.28
 2020,Hamlin,SD,"Hamlin, SD",52353,18,795,34071,18282,1.54
 2021,Hamlin,SD,"Hamlin, SD",57440,10,923,39557,17883,1.45
 2019,Hampden,MA,"Hampden, MA",53167,0,1098,47057,6110,1.13
 2020,Hampden,MA,"Hampden, MA",58071,9,1235,52929,5142,1.1
 2021,Hampden,MA,"Hampden, MA",61522,6,1299,55671,5851,1.11
 2019,Hampshire,MA,"Hampshire, MA",54754,0,1609,68957,-14203,0.79
 2020,Hampshire,MA,"Hampshire, MA",58133,6,1770,75857,-17724,0.77
 2021,Hampshire,MA,"Hampshire, MA",60717,4,2126,91114,-30397,0.67
 2019,Hampshire,WV,"Hampshire, WV",38321,0,862,36943,1378,1.04
 2020,Hampshire,WV,"Hampshire, WV",40634,6,877,37586,3048,1.08
 2021,Hampshire,WV,"Hampshire, WV",43618,7,1016,43543,75,1
 2019,Hampton,SC,"Hampton, SC",33314,0,580,24857,8457,1.34
 2020,Hampton,SC,"Hampton, SC",38107,14,497,21300,16807,1.79
 2021,Hampton,SC,"Hampton, SC",41689,9,810,34714,6975,1.2
 2019,Hancock,GA,"Hancock, GA",30507,0,902,38657,-8150,0.79
 2020,Hancock,GA,"Hancock, GA",32961,8,1326,56829,-23868,0.58
 2021,Hancock,GA,"Hancock, GA",35778,9,1617,69300,-33522,0.52
 2019,Hancock,IA,"Hancock, IA",51271,0,700,30000,21271,1.71
 2020,Hancock,IA,"Hancock, IA",52914,3,622,26657,26257,1.98
 2021,Hancock,IA,"Hancock, IA",61201,16,726,31114,30087,1.97
 2019,Hancock,IL,"Hancock, IL",44091,0,423,18129,25962,2.43
 2020,Hancock,IL,"Hancock, IL",50006,13,447,19157,30849,2.61
 2021,Hancock,IL,"Hancock, IL",55095,10,477,20443,34652,2.7
 2019,Hancock,IN,"Hancock, IN",51936,0,1203,51557,379,1.01
 2020,Hancock,IN,"Hancock, IN",54658,5,1240,53143,1515,1.03
 2021,Hancock,IN,"Hancock, IN",58095,6,1644,70457,-12362,0.82
 2019,Hancock,KY,"Hancock, KY",39821,0,603,25843,13978,1.54
 2020,Hancock,KY,"Hancock, KY",42781,7,941,40329,2452,1.06
 2021,Hancock,KY,"Hancock, KY",46528,9,1017,43586,2942,1.07
 2019,Hancock,ME,"Hancock, ME",53152,0,1675,71786,-18634,0.74
 2020,Hancock,ME,"Hancock, ME",56977,7,1782,76371,-19394,0.75
 2021,Hancock,ME,"Hancock, ME",60105,6,2287,98014,-37909,0.61
 2019,Hancock,MS,"Hancock, MS",38155,0,963,41271,-3116,0.92
 2020,Hancock,MS,"Hancock, MS",41867,10,1100,47143,-5276,0.89
 2021,Hancock,MS,"Hancock, MS",44776,7,1592,68229,-23453,0.66
 2019,Hancock,OH,"Hancock, OH",51102,0,919,39386,11716,1.3
 2020,Hancock,OH,"Hancock, OH",55871,9,982,42086,13785,1.33
 2021,Hancock,OH,"Hancock, OH",58966,6,1034,44314,14652,1.33
 2019,Hancock,TN,"Hancock, TN",28021,0,669,28671,-650,0.98
 2020,Hancock,TN,"Hancock, TN",31325,12,755,32357,-1032,0.97
 2021,Hancock,TN,"Hancock, TN",34135,9,859,36814,-2679,0.93
 2019,Hancock,WV,"Hancock, WV",43244,0,448,19200,24044,2.25
 2020,Hancock,WV,"Hancock, WV",46145,7,454,19457,26688,2.37
 2021,Hancock,WV,"Hancock, WV",49823,8,641,27471,22352,1.81
 2019,Hanover,VA,"Hanover, VA",61617,0,1956,83829,-22212,0.74
 2020,Hanover,VA,"Hanover, VA",65636,7,1915,82071,-16435,0.8
 2021,Hanover,VA,"Hanover, VA",68934,5,2372,101657,-32723,0.68
 2019,Hansford,TX,"Hansford, TX",65541,0,578,24771,40770,2.65
 2020,Hansford,TX,"Hansford, TX",68396,4,612,26229,42167,2.61
 2021,Hansford,TX,"Hansford, TX",77093,13,641,27471,49622,2.81
 2019,Hanson,SD,"Hanson, SD",65767,0,1088,46629,19138,1.41
 2020,Hanson,SD,"Hanson, SD",71333,9,611,26186,45147,2.72
 2021,Hanson,SD,"Hanson, SD",77579,9,1185,50786,26793,1.53
 2019,Haralson,GA,"Haralson, GA",38370,0,995,42643,-4273,0.9
 2020,Haralson,GA,"Haralson, GA",40611,6,1033,44271,-3660,0.92
 2021,Haralson,GA,"Haralson, GA",44003,8,1387,59443,-15440,0.74
 2019,Hardee,FL,"Hardee, FL",29812,0,1122,48086,-18274,0.62
 2020,Hardee,FL,"Hardee, FL",32358,9,985,42214,-9856,0.77
 2021,Hardee,FL,"Hardee, FL",35636,10,1959,83957,-48321,0.42
 2019,Hardeman,TN,"Hardeman, TN",30266,0,663,28414,1852,1.07
 2020,Hardeman,TN,"Hardeman, TN",32742,8,674,28886,3856,1.13
 2021,Hardeman,TN,"Hardeman, TN",35485,8,1006,43114,-7629,0.82
 2019,Hardeman,TX,"Hardeman, TX",47727,0,202,8657,39070,5.51
 2020,Hardeman,TX,"Hardeman, TX",51245,7,199,8529,42716,6.01
 2021,Hardeman,TX,"Hardeman, TX",54847,7,510,21857,32990,2.51
 2019,Hardin,IA,"Hardin, IA",48055,0,459,19671,28384,2.44
 2020,Hardin,IA,"Hardin, IA",49955,4,524,22457,27498,2.22
 2021,Hardin,IA,"Hardin, IA",56678,14,478,20486,36192,2.77
 2019,Hardin,IL,"Hardin, IL",39129,0,417,17871,21258,2.19
 2020,Hardin,IL,"Hardin, IL",43237,11,472,20229,23008,2.14
 2021,Hardin,IL,"Hardin, IL",46724,8,407,17443,29281,2.68
 2019,Hardin,KY,"Hardin, KY",44708,0,974,41743,2965,1.07
 2020,Hardin,KY,"Hardin, KY",48193,8,1063,45557,2636,1.06
 2021,Hardin,KY,"Hardin, KY",51525,7,1210,51857,-332,0.99
 2019,Hardin,OH,"Hardin, OH",33937,0,446,19114,14823,1.78
 2020,Hardin,OH,"Hardin, OH",37515,11,474,20314,17201,1.85
 2021,Hardin,OH,"Hardin, OH",40636,8,671,28757,11879,1.41
 2019,Hardin,TN,"Hardin, TN",39199,0,1064,45600,-6401,0.86
 2020,Hardin,TN,"Hardin, TN",42352,8,1074,46029,-3677,0.92
 2021,Hardin,TN,"Hardin, TN",45053,6,1191,51043,-5990,0.88
 2019,Hardin,TX,"Hardin, TX",49402,0,1063,45557,3845,1.08
 2020,Hardin,TX,"Hardin, TX",50697,3,1142,48943,1754,1.04
 2021,Hardin,TX,"Hardin, TX",52544,4,1312,56229,-3685,0.93
 2019,Harding,NM,"Harding, NM",40555,0,1783,76414,-35859,0.53
 2020,Harding,NM,"Harding, NM",46965,16,2062,88371,-41406,0.53
 2021,Harding,NM,"Harding, NM",49695,6,1799,77100,-27405,0.64
 2019,Harding,SD,"Harding, SD",51121,0,0,0,51121,0
 2020,Harding,SD,"Harding, SD",49327,-4,408,17486,31841,2.82
 2021,Harding,SD,"Harding, SD",60414,23,638,27343,33071,2.21
 2019,Hardy,WV,"Hardy, WV",34343,0,831,35614,-1271,0.96
 2020,Hardy,WV,"Hardy, WV",36312,6,771,33043,3269,1.1
 2021,Hardy,WV,"Hardy, WV",40562,12,1317,56443,-15881,0.72
 2019,Harford,MD,"Harford, MD",59333,0,1495,64071,-4738,0.93
 2020,Harford,MD,"Harford, MD",62868,6,1718,73629,-10761,0.85
 2021,Harford,MD,"Harford, MD",66633,6,1690,72429,-5796,0.92
 2019,Harlan,KY,"Harlan, KY",30406,0,396,16971,13435,1.79
 2020,Harlan,KY,"Harlan, KY",34304,13,411,17614,16690,1.95
 2021,Harlan,KY,"Harlan, KY",39123,14,502,21514,17609,1.82
 2019,Harlan,NE,"Harlan, NE",57567,0,583,24986,32581,2.3
 2020,Harlan,NE,"Harlan, NE",63737,11,362,15514,48223,4.11
 2021,Harlan,NE,"Harlan, NE",66306,4,1154,49457,16849,1.34
 2019,Harmon,OK,"Harmon, OK",41603,0,541,23186,18417,1.79
 2020,Harmon,OK,"Harmon, OK",45852,10,682,29229,16623,1.57
 2021,Harmon,OK,"Harmon, OK",51088,11,624,26743,24345,1.91
 2019,Harnett,NC,"Harnett, NC",36681,0,1078,46200,-9519,0.79
 2020,Harnett,NC,"Harnett, NC",39500,8,1163,49843,-10343,0.79
 2021,Harnett,NC,"Harnett, NC",43484,10,1375,58929,-15445,0.74
 2019,Harney,OR,"Harney, OR",40504,0,603,25843,14661,1.57
 2020,Harney,OR,"Harney, OR",44912,11,430,18429,26483,2.44
 2021,Harney,OR,"Harney, OR",49257,10,1186,50829,-1572,0.97
 2019,Harper,KS,"Harper, KS",51444,0,271,11614,39830,4.43
 2020,Harper,KS,"Harper, KS",57680,12,335,14357,43323,4.02
 2021,Harper,KS,"Harper, KS",61799,7,324,13886,47913,4.45
 2019,Harper,OK,"Harper, OK",54839,0,264,11314,43525,4.85
 2020,Harper,OK,"Harper, OK",52763,-4,341,14614,38149,3.61
 2021,Harper,OK,"Harper, OK",54555,3,210,9000,45555,6.06
 2019,Harris,GA,"Harris, GA",50679,0,1443,61843,-11164,0.82
 2020,Harris,GA,"Harris, GA",52889,4,1544,66171,-13282,0.8
 2021,Harris,GA,"Harris, GA",56595,7,1907,81729,-25134,0.69
 2019,Harris,TX,"Harris, TX",60566,0,1467,62871,-2305,0.96
 2020,Harris,TX,"Harris, TX",61643,2,1449,62100,-457,0.99
 2021,Harris,TX,"Harris, TX",65869,7,1706,73114,-7245,0.9
 2019,Harrison,IA,"Harrison, IA",46305,0,463,19843,26462,2.33
 2020,Harrison,IA,"Harrison, IA",48857,6,809,34671,14186,1.41
 2021,Harrison,IA,"Harrison, IA",55468,14,760,32571,22897,1.7
 2019,Harrison,IN,"Harrison, IN",44710,0,985,42214,2496,1.06
 2020,Harrison,IN,"Harrison, IN",47866,7,791,33900,13966,1.41
 2021,Harrison,IN,"Harrison, IN",51770,8,1106,47400,4370,1.09
 2019,Harrison,KY,"Harrison, KY",37622,0,847,36300,1322,1.04
 2020,Harrison,KY,"Harrison, KY",41120,9,1293,55414,-14294,0.74
 2021,Harrison,KY,"Harrison, KY",43811,7,1083,46414,-2603,0.94
 2019,Harrison,MO,"Harrison, MO",37241,0,1203,51557,-14316,0.72
 2020,Harrison,MO,"Harrison, MO",41726,12,717,30729,10997,1.36
 2021,Harrison,MO,"Harrison, MO",43767,5,465,19929,23838,2.2
 2019,Harrison,MS,"Harrison, MS",38492,0,1010,43286,-4794,0.89
 2020,Harrison,MS,"Harrison, MS",42037,9,1040,44571,-2534,0.94
 2021,Harrison,MS,"Harrison, MS",44551,6,1276,54686,-10135,0.81
 2019,Harrison,OH,"Harrison, OH",40834,0,398,17057,23777,2.39
 2020,Harrison,OH,"Harrison, OH",43497,7,409,17529,25968,2.48
 2021,Harrison,OH,"Harrison, OH",45968,6,565,24214,21754,1.9
 2019,Harrison,TX,"Harrison, TX",43516,0,1005,43071,445,1.01
 2020,Harrison,TX,"Harrison, TX",44884,3,1023,43843,1041,1.02
 2021,Harrison,TX,"Harrison, TX",47928,7,1008,43200,4728,1.11
 2019,Harrison,WV,"Harrison, WV",51627,0,874,37457,14170,1.38
 2020,Harrison,WV,"Harrison, WV",53339,3,627,26871,26468,1.99
 2021,Harrison,WV,"Harrison, WV",57205,7,763,32700,24505,1.75
 2019,Hart,GA,"Hart, GA",39262,0,1179,50529,-11267,0.78
 2020,Hart,GA,"Hart, GA",40960,4,1225,52500,-11540,0.78
 2021,Hart,GA,"Hart, GA",43900,7,1466,62829,-18929,0.7
 2019,Hart,KY,"Hart, KY",34111,0,681,29186,4925,1.17
 2020,Hart,KY,"Hart, KY",36774,8,631,27043,9731,1.36
 2021,Hart,KY,"Hart, KY",40257,10,869,37243,3014,1.08
 2019,Hartford,CT,"Hartford, CT",64283,0,1241,53186,11097,1.21
 2020,Hartford,CT,"Hartford, CT",67205,5,1322,56657,10548,1.19
 2021,Hartford,CT,"Hartford, CT",70168,4,1469,62957,7211,1.11
 2019,Hartley,TX,"Hartley, TX",74916,0,1115,47786,27130,1.57
 2020,Hartley,TX,"Hartley, TX",76075,2,1249,53529,22546,1.42
 2021,Hartley,TX,"Hartley, TX",75790,0,1248,53486,22304,1.42
 2019,Harvey,KS,"Harvey, KS",44381,0,655,28071,16310,1.58
 2020,Harvey,KS,"Harvey, KS",47580,7,632,27086,20494,1.76
 2021,Harvey,KS,"Harvey, KS",49642,4,730,31286,18356,1.59
 2019,Haskell,KS,"Haskell, KS",53293,0,583,24986,28307,2.13
 2020,Haskell,KS,"Haskell, KS",62329,17,559,23957,38372,2.6
 2021,Haskell,KS,"Haskell, KS",70901,14,878,37629,33272,1.88
 2019,Haskell,OK,"Haskell, OK",36002,0,780,33429,2573,1.08
 2020,Haskell,OK,"Haskell, OK",37707,5,675,28929,8778,1.3
 2021,Haskell,OK,"Haskell, OK",42506,13,876,37543,4963,1.13
 2019,Haskell,TX,"Haskell, TX",47449,0,421,18043,29406,2.63
 2020,Haskell,TX,"Haskell, TX",48768,3,481,20614,28154,2.37
 2021,Haskell,TX,"Haskell, TX",54321,11,681,29186,25135,1.86
 2019,Hawaii,HI,"Hawaii, HI",43585,0,2327,99729,-56144,0.44
 2020,Hawaii,HI,"Hawaii, HI",47068,8,2122,90943,-43875,0.52
 2021,Hawaii,HI,"Hawaii, HI",50038,6,2595,111214,-61176,0.45
 2019,Hawkins,TN,"Hawkins, TN",35369,0,736,31543,3826,1.12
 2020,Hawkins,TN,"Hawkins, TN",38232,8,938,40200,-1968,0.95
 2021,Hawkins,TN,"Hawkins, TN",41436,8,1086,46543,-5107,0.89
 2019,Hayes,NE,"Hayes, NE",70204,0,1439,61671,8533,1.14
 2020,Hayes,NE,"Hayes, NE",81633,16,1271,54471,27162,1.5
 2021,Hayes,NE,"Hayes, NE",90144,10,312,13371,76773,6.74
 2019,Hays,TX,"Hays, TX",48754,0,1569,67243,-18489,0.73
 2020,Hays,TX,"Hays, TX",51359,5,1609,68957,-17598,0.74
 2021,Hays,TX,"Hays, TX",56097,9,2653,113700,-57603,0.49
 2019,Haywood,NC,"Haywood, NC",42758,0,1473,63129,-20371,0.68
 2020,Haywood,NC,"Haywood, NC",45709,7,1559,66814,-21105,0.68
 2021,Haywood,NC,"Haywood, NC",49639,9,1881,80614,-30975,0.62
 2019,Haywood,TN,"Haywood, TN",33721,0,398,17057,16664,1.98
 2020,Haywood,TN,"Haywood, TN",36712,9,444,19029,17683,1.93
 2021,Haywood,TN,"Haywood, TN",41503,13,651,27900,13603,1.49
 2019,Heard,GA,"Heard, GA",33872,0,1256,53829,-19957,0.63
 2020,Heard,GA,"Heard, GA",36081,7,968,41486,-5405,0.87
 2021,Heard,GA,"Heard, GA",39769,10,1118,47914,-8145,0.83
 2019,Hemphill,TX,"Hemphill, TX",68610,0,770,33000,35610,2.08
 2020,Hemphill,TX,"Hemphill, TX",69936,2,1109,47529,22407,1.47
 2021,Hemphill,TX,"Hemphill, TX",75731,8,693,29700,46031,2.55
 2019,Hempstead,AR,"Hempstead, AR",33624,0,688,29486,4138,1.14
 2020,Hempstead,AR,"Hempstead, AR",35784,6,743,31843,3941,1.12
 2021,Hempstead,AR,"Hempstead, AR",41269,15,649,27814,13455,1.48
 2019,Henderson,IL,"Henderson, IL",41244,0,414,17743,23501,2.32
 2020,Henderson,IL,"Henderson, IL",47473,15,375,16071,31402,2.95
 2021,Henderson,IL,"Henderson, IL",54766,15,517,22157,32609,2.47
 2019,Henderson,KY,"Henderson, KY",41157,0,733,31414,9743,1.31
 2020,Henderson,KY,"Henderson, KY",45247,10,795,34071,11176,1.33
 2021,Henderson,KY,"Henderson, KY",49580,10,647,27729,21851,1.79
 2019,Henderson,NC,"Henderson, NC",46609,0,1810,77571,-30962,0.6
 2020,Henderson,NC,"Henderson, NC",48613,4,1950,83571,-34958,0.58
 2021,Henderson,NC,"Henderson, NC",52634,8,2096,89829,-37195,0.59
 2019,Henderson,TN,"Henderson, TN",37644,0,833,35700,1944,1.05
 2020,Henderson,TN,"Henderson, TN",40776,8,932,39943,833,1.02
 2021,Henderson,TN,"Henderson, TN",44357,9,1220,52286,-7929,0.85
 2019,Henderson,TX,"Henderson, TX",42660,0,1140,48857,-6197,0.87
 2020,Henderson,TX,"Henderson, TX",44938,5,1111,47614,-2676,0.94
 2021,Henderson,TX,"Henderson, TX",48594,8,1564,67029,-18435,0.72
 2019,Hendricks,IN,"Hendricks, IN",51087,0,1280,54857,-3770,0.93
 2020,Hendricks,IN,"Hendricks, IN",54712,7,1393,59700,-4988,0.92
 2021,Hendricks,IN,"Hendricks, IN",59804,9,1570,67286,-7482,0.89
 2019,Hendry,FL,"Hendry, FL",34352,0,982,42086,-7734,0.82
 2020,Hendry,FL,"Hendry, FL",37672,10,1068,45771,-8099,0.82
 2021,Hendry,FL,"Hendry, FL",39699,5,1281,54900,-15201,0.72
 2019,Hennepin,MN,"Hennepin, MN",76905,0,2217,95014,-18109,0.81
 2020,Hennepin,MN,"Hennepin, MN",80429,5,2013,86271,-5842,0.93
 2021,Hennepin,MN,"Hennepin, MN",85505,6,1603,68700,16805,1.24
 2019,Henrico,VA,"Henrico, VA",68826,0,1621,69471,-645,0.99
 2020,Henrico,VA,"Henrico, VA",69938,2,1610,69000,938,1.01
 2021,Henrico,VA,"Henrico, VA",74650,7,1557,66729,7921,1.12
 2019,Henry,AL,"Henry, AL",44657,0,938,40200,4457,1.11
 2020,Henry,AL,"Henry, AL",46518,4,1080,46286,232,1.01
 2021,Henry,AL,"Henry, AL",51184,10,813,34843,16341,1.47
 2019,Henry,GA,"Henry, GA",39910,0,1207,51729,-11819,0.77
 2020,Henry,GA,"Henry, GA",43389,9,1247,53443,-10054,0.81
 2021,Henry,GA,"Henry, GA",46961,8,1768,75771,-28810,0.62
 2019,Henry,IA,"Henry, IA",42438,0,807,34586,7852,1.23
 2020,Henry,IA,"Henry, IA",45033,6,755,32357,12676,1.39
 2021,Henry,IA,"Henry, IA",49117,9,696,29829,19288,1.65
 2019,Henry,IL,"Henry, IL",45785,0,536,22971,22814,1.99
 2020,Henry,IL,"Henry, IL",50273,10,525,22500,27773,2.23
 2021,Henry,IL,"Henry, IL",54747,9,594,25457,29290,2.15
 2019,Henry,IN,"Henry, IN",39075,0,378,16200,22875,2.41
 2020,Henry,IN,"Henry, IN",42443,9,405,17357,25086,2.45
 2021,Henry,IN,"Henry, IN",46146,9,597,25586,20560,1.8
 2019,Henry,KY,"Henry, KY",41062,0,962,41229,-167,1
 2020,Henry,KY,"Henry, KY",44800,9,982,42086,2714,1.06
 2021,Henry,KY,"Henry, KY",48943,9,1102,47229,1714,1.04
 2019,Henry,MO,"Henry, MO",41931,0,396,16971,24960,2.47
 2020,Henry,MO,"Henry, MO",45715,9,476,20400,25315,2.24
 2021,Henry,MO,"Henry, MO",48924,7,824,35314,13610,1.39
 2019,Henry,OH,"Henry, OH",44961,0,608,26057,18904,1.73
 2020,Henry,OH,"Henry, OH",49383,10,650,27857,21526,1.77
 2021,Henry,OH,"Henry, OH",52568,6,668,28629,23939,1.84
 2019,Henry,TN,"Henry, TN",42710,0,775,33214,9496,1.29
 2020,Henry,TN,"Henry, TN",46773,10,827,35443,11330,1.32
 2021,Henry,TN,"Henry, TN",49852,7,1026,43971,5881,1.13
 2019,Herkimer,NY,"Herkimer, NY",44074,0,675,28929,15145,1.52
 2020,Herkimer,NY,"Herkimer, NY",48208,9,725,31071,17137,1.55
 2021,Herkimer,NY,"Herkimer, NY",51946,8,736,31543,20403,1.65
 2019,Hertford,NC,"Hertford, NC",35068,0,579,24814,10254,1.41
 2020,Hertford,NC,"Hertford, NC",38879,11,497,21300,17579,1.83
 2021,Hertford,NC,"Hertford, NC",41973,8,715,30643,11330,1.37
 2019,Hettinger,ND,"Hettinger, ND",48588,0,444,19029,29559,2.55
 2020,Hettinger,ND,"Hettinger, ND",59125,22,524,22457,36668,2.63
 2021,Hettinger,ND,"Hettinger, ND",58160,-2,1183,50700,7460,1.15
 2019,Hickman,KY,"Hickman, KY",41845,0,369,15814,26031,2.65
 2020,Hickman,KY,"Hickman, KY",42155,1,443,18986,23169,2.22
 2021,Hickman,KY,"Hickman, KY",54685,30,751,32186,22499,1.7
 2019,Hickman,TN,"Hickman, TN",35945,0,1044,44743,-8798,0.8
 2020,Hickman,TN,"Hickman, TN",37869,5,1066,45686,-7817,0.83
 2021,Hickman,TN,"Hickman, TN",41689,10,1450,62143,-20454,0.67
 2019,Hickory,MO,"Hickory, MO",33430,0,469,20100,13330,1.66
 2020,Hickory,MO,"Hickory, MO",36800,10,659,28243,8557,1.3
 2021,Hickory,MO,"Hickory, MO",38100,4,1080,46286,-8186,0.82
 2019,Hidalgo,NM,"Hidalgo, NM",42896,0,509,21814,21082,1.97
 2020,Hidalgo,NM,"Hidalgo, NM",47293,10,562,24086,23207,1.96
 2021,Hidalgo,NM,"Hidalgo, NM",51465,9,975,41786,9679,1.23
 2019,Hidalgo,TX,"Hidalgo, TX",28256,0,914,39171,-10915,0.72
 2020,Hidalgo,TX,"Hidalgo, TX",31342,11,942,40371,-9029,0.78
 2021,Hidalgo,TX,"Hidalgo, TX",34503,10,1252,53657,-19154,0.64
 2019,Hill,MT,"Hill, MT",45861,0,937,40157,5704,1.14
 2020,Hill,MT,"Hill, MT",49714,8,892,38229,11485,1.3
 2021,Hill,MT,"Hill, MT",51060,3,956,40971,10089,1.25
 2019,Hill,TX,"Hill, TX",43673,0,856,36686,6987,1.19
 2020,Hill,TX,"Hill, TX",46134,6,876,37543,8591,1.23
 2021,Hill,TX,"Hill, TX",49968,8,1090,46714,3254,1.07
 2019,Hillsborough,FL,"Hillsborough, FL",50058,0,1344,57600,-7542,0.87
 2020,Hillsborough,FL,"Hillsborough, FL",53432,7,1383,59271,-5839,0.9
 2021,Hillsborough,FL,"Hillsborough, FL",58140,9,1889,80957,-22817,0.72
 2019,Hillsborough,NH,"Hillsborough, NH",63263,0,1714,73457,-10194,0.86
 2020,Hillsborough,NH,"Hillsborough, NH",67127,6,1804,77314,-10187,0.87
 2021,Hillsborough,NH,"Hillsborough, NH",71849,7,2041,87471,-15622,0.82
 2019,Hillsdale,MI,"Hillsdale, MI",35908,0,651,27900,8008,1.29
 2020,Hillsdale,MI,"Hillsdale, MI",39486,10,774,33171,6315,1.19
 2021,Hillsdale,MI,"Hillsdale, MI",42365,7,783,33557,8808,1.26
 2019,Hinds,MS,"Hinds, MS",40535,0,763,32700,7835,1.24
 2020,Hinds,MS,"Hinds, MS",44415,10,743,31843,12572,1.39
 2021,Hinds,MS,"Hinds, MS",47413,7,877,37586,9827,1.26
 2019,Hinsdale,CO,"Hinsdale, CO",50952,0,2183,93557,-42605,0.54
 2020,Hinsdale,CO,"Hinsdale, CO",52257,3,2545,109071,-56814,0.48
 2021,Hinsdale,CO,"Hinsdale, CO",56524,8,2848,122057,-65533,0.46
 2019,Hitchcock,NE,"Hitchcock, NE",42440,0,299,12814,29626,3.31
 2020,Hitchcock,NE,"Hitchcock, NE",49549,17,379,16243,33306,3.05
 2021,Hitchcock,NE,"Hitchcock, NE",59923,21,631,27043,32880,2.22
 2019,Hocking,OH,"Hocking, OH",39909,0,763,32700,7209,1.22
 2020,Hocking,OH,"Hocking, OH",43539,9,1159,49671,-6132,0.88
 2021,Hocking,OH,"Hocking, OH",46421,7,825,35357,11064,1.31
 2019,Hockley,TX,"Hockley, TX",45384,0,721,30900,14484,1.47
 2020,Hockley,TX,"Hockley, TX",48966,8,637,27300,21666,1.79
 2021,Hockley,TX,"Hockley, TX",52586,7,839,35957,16629,1.46
 2019,Hodgeman,KS,"Hodgeman, KS",55828,0,461,19757,36071,2.83
 2020,Hodgeman,KS,"Hodgeman, KS",65216,17,264,11314,53902,5.76
 2021,Hodgeman,KS,"Hodgeman, KS",67659,4,237,10157,57502,6.66
 2019,Hoke,NC,"Hoke, NC",34507,0,1032,44229,-9722,0.78
 2020,Hoke,NC,"Hoke, NC",37467,9,1080,46286,-8819,0.81
 2021,Hoke,NC,"Hoke, NC",41652,11,1248,53486,-11834,0.78
 2019,Holmes,FL,"Holmes, FL",32243,0,718,30771,1472,1.05
 2020,Holmes,FL,"Holmes, FL",34564,7,706,30257,4307,1.14
 2021,Holmes,FL,"Holmes, FL",37381,8,1218,52200,-14819,0.72
 2019,Holmes,MS,"Holmes, MS",29433,0,296,12686,16747,2.32
 2020,Holmes,MS,"Holmes, MS",33280,13,414,17743,15537,1.88
 2021,Holmes,MS,"Holmes, MS",36339,9,555,23786,12553,1.53
 2019,Holmes,OH,"Holmes, OH",47387,0,1281,54900,-7513,0.86
 2020,Holmes,OH,"Holmes, OH",50516,7,902,38657,11859,1.31
 2021,Holmes,OH,"Holmes, OH",54118,7,893,38271,15847,1.41
 2019,Holt,MO,"Holt, MO",50637,0,571,24471,26166,2.07
 2020,Holt,MO,"Holt, MO",56930,12,578,24771,32159,2.3
 2021,Holt,MO,"Holt, MO",58888,3,519,22243,36645,2.65
 2019,Holt,NE,"Holt, NE",52409,0,602,25800,26609,2.03
 2020,Holt,NE,"Holt, NE",59866,14,665,28500,31366,2.1
 2021,Holt,NE,"Holt, NE",66231,11,819,35100,31131,1.89
 2019,Honolulu,HI,"Honolulu, HI",57560,0,3352,143657,-86097,0.4
 2020,Honolulu,HI,"Honolulu, HI",60114,4,3054,130886,-70772,0.46
 2021,Honolulu,HI,"Honolulu, HI",63912,6,3392,145371,-81459,0.44
 2019,Hood River,OR,"Hood River, OR",55537,0,2567,110014,-54477,0.5
 2020,Hood River,OR,"Hood River, OR",60167,8,2357,101014,-40847,0.6
 2021,Hood River,OR,"Hood River, OR",65127,8,3979,170529,-105402,0.38
 2019,Hood,TX,"Hood, TX",55491,0,1308,56057,-566,0.99
 2020,Hood,TX,"Hood, TX",57625,4,1435,61500,-3875,0.94
 2021,Hood,TX,"Hood, TX",60912,6,1850,79286,-18374,0.77
 2019,Hooker,NE,"Hooker, NE",47599,0,0,0,47599,0
 2020,Hooker,NE,"Hooker, NE",48980,3,594,25457,23523,1.92
 2021,Hooker,NE,"Hooker, NE",49027,0,465,19929,29098,2.46
 2019,Hoonah-angoon,AK,"Hoonah-angoon, AK",59560,0,1048,44914,14646,1.33
 2020,Hoonah-angoon,AK,"Hoonah-angoon, AK",56226,-6,1017,43586,12640,1.29
 2021,Hoonah-angoon,AK,"Hoonah-angoon, AK",60837,8,1415,60643,194,1
 2019,Hopkins,KY,"Hopkins, KY",40078,0,627,26871,13207,1.49
 2020,Hopkins,KY,"Hopkins, KY",42536,6,621,26614,15922,1.6
 2021,Hopkins,KY,"Hopkins, KY",46673,10,842,36086,10587,1.29
 2019,Hopkins,TX,"Hopkins, TX",43351,0,909,38957,4394,1.11
 2020,Hopkins,TX,"Hopkins, TX",46014,6,944,40457,5557,1.14
 2021,Hopkins,TX,"Hopkins, TX",50272,9,1239,53100,-2828,0.95
 2019,Horry,SC,"Horry, SC",41360,0,1129,48386,-7026,0.85
 2020,Horry,SC,"Horry, SC",44241,7,1134,48600,-4359,0.91
 2021,Horry,SC,"Horry, SC",46817,6,1703,72986,-26169,0.64
 2019,Hot Spring,AR,"Hot Spring, AR",32211,0,626,26829,5382,1.2
 2020,Hot Spring,AR,"Hot Spring, AR",34907,8,818,35057,-150,1
 2021,Hot Spring,AR,"Hot Spring, AR",37474,7,766,32829,4645,1.14
 2019,Hot Springs,WY,"Hot Springs, WY",61472,0,742,31800,29672,1.93
 2020,Hot Springs,WY,"Hot Springs, WY",75185,22,723,30986,44199,2.43
 2021,Hot Springs,WY,"Hot Springs, WY",78817,5,919,39386,39431,2
 2019,Houghton,MI,"Houghton, MI",37044,0,590,25286,11758,1.47
 2020,Houghton,MI,"Houghton, MI",40803,10,688,29486,11317,1.38
 2021,Houghton,MI,"Houghton, MI",43809,7,679,29100,14709,1.51
 2019,Houston,AL,"Houston, AL",44250,0,873,37414,6836,1.18
 2020,Houston,AL,"Houston, AL",47648,8,932,39943,7705,1.19
 2021,Houston,AL,"Houston, AL",50976,7,1096,46971,4005,1.09
 2019,Houston,GA,"Houston, GA",43165,0,1053,45129,-1964,0.96
 2020,Houston,GA,"Houston, GA",45536,6,1089,46671,-1135,0.98
 2021,Houston,GA,"Houston, GA",48929,8,1269,54386,-5457,0.9
 2019,Houston,MN,"Houston, MN",51628,0,962,41229,10399,1.25
 2020,Houston,MN,"Houston, MN",55330,7,1135,48643,6687,1.14
 2021,Houston,MN,"Houston, MN",59140,7,1251,53614,5526,1.1
 2019,Houston,TN,"Houston, TN",34415,0,625,26786,7629,1.28
 2020,Houston,TN,"Houston, TN",36475,6,718,30771,5704,1.19
 2021,Houston,TN,"Houston, TN",39128,7,1117,47871,-8743,0.82
 2019,Houston,TX,"Houston, TX",42259,0,823,35271,6988,1.2
 2020,Houston,TX,"Houston, TX",45960,9,698,29914,16046,1.54
 2021,Houston,TX,"Houston, TX",48835,6,891,38186,10649,1.28
 2019,Howard,AR,"Howard, AR",34864,0,680,29143,5721,1.2
 2020,Howard,AR,"Howard, AR",35669,2,625,26786,8883,1.33
 2021,Howard,AR,"Howard, AR",42224,18,730,31286,10938,1.35
 2019,Howard,IA,"Howard, IA",47764,0,598,25629,22135,1.86
 2020,Howard,IA,"Howard, IA",51067,7,520,22286,28781,2.29
 2021,Howard,IA,"Howard, IA",58411,14,887,38014,20397,1.54
 2019,Howard,IN,"Howard, IN",41863,0,542,23229,18634,1.8
 2020,Howard,IN,"Howard, IN",44266,6,575,24643,19623,1.8
 2021,Howard,IN,"Howard, IN",47031,6,575,24643,22388,1.91
 2019,Howard,MD,"Howard, MD",78013,0,2454,105171,-27158,0.74
 2020,Howard,MD,"Howard, MD",82041,5,2861,122614,-40573,0.67
 2021,Howard,MD,"Howard, MD",86380,5,2624,112457,-26077,0.77
 2019,Howard,MO,"Howard, MO",40891,0,539,23100,17791,1.77
 2020,Howard,MO,"Howard, MO",44142,8,847,36300,7842,1.22
 2021,Howard,MO,"Howard, MO",46854,6,1190,51000,-4146,0.92
 2019,Howard,NE,"Howard, NE",46850,0,977,41871,4979,1.12
 2020,Howard,NE,"Howard, NE",52024,11,1070,45857,6167,1.13
 2021,Howard,NE,"Howard, NE",55957,8,1023,43843,12114,1.28
 2019,Howard,TX,"Howard, TX",46684,0,865,37071,9613,1.26
 2020,Howard,TX,"Howard, TX",46964,1,764,32743,14221,1.43
 2021,Howard,TX,"Howard, TX",51007,9,913,39129,11878,1.3
 2019,Howell,MO,"Howell, MO",35728,0,678,29057,6671,1.23
 2020,Howell,MO,"Howell, MO",38446,8,776,33257,5189,1.16
 2021,Howell,MO,"Howell, MO",40358,5,790,33857,6501,1.19
 2019,Hubbard,MN,"Hubbard, MN",50828,0,1084,46457,4371,1.09
 2020,Hubbard,MN,"Hubbard, MN",53768,6,1156,49543,4225,1.09
 2021,Hubbard,MN,"Hubbard, MN",57111,6,1407,60300,-3189,0.95
 2019,Hudson,NJ,"Hudson, NJ",64645,0,2510,107571,-42926,0.6
 2020,Hudson,NJ,"Hudson, NJ",65509,1,2529,108386,-42877,0.6
 2021,Hudson,NJ,"Hudson, NJ",72046,10,2531,108471,-36425,0.66
 2019,Hudspeth,TX,"Hudspeth, TX",34986,0,1309,56100,-21114,0.62
 2020,Hudspeth,TX,"Hudspeth, TX",39393,13,893,38271,1122,1.03
 2021,Hudspeth,TX,"Hudspeth, TX",42500,8,1180,50571,-8071,0.84
 2019,Huerfano,CO,"Huerfano, CO",41653,0,1518,65057,-23404,0.64
 2020,Huerfano,CO,"Huerfano, CO",45781,10,1636,70114,-24333,0.65
 2021,Huerfano,CO,"Huerfano, CO",48801,7,1825,78214,-29413,0.62
 2019,Hughes,OK,"Hughes, OK",41203,0,421,18043,23160,2.28
 2020,Hughes,OK,"Hughes, OK",40999,-1,441,18900,22099,2.17
 2021,Hughes,OK,"Hughes, OK",46703,14,448,19200,27503,2.43
 2019,Hughes,SD,"Hughes, SD",53823,0,1066,45686,8137,1.18
 2020,Hughes,SD,"Hughes, SD",55955,4,1223,52414,3541,1.07
 2021,Hughes,SD,"Hughes, SD",61666,10,1651,70757,-9091,0.87
 2019,Humboldt,CA,"Humboldt, CA",46285,0,1796,76971,-30686,0.6
 2020,Humboldt,CA,"Humboldt, CA",50693,10,1690,72429,-21736,0.7
 2021,Humboldt,CA,"Humboldt, CA",53607,6,2397,102729,-49122,0.52
 2019,Humboldt,IA,"Humboldt, IA",49608,0,655,28071,21537,1.77
 2020,Humboldt,IA,"Humboldt, IA",51870,5,861,36900,14970,1.41
 2021,Humboldt,IA,"Humboldt, IA",56985,10,689,29529,27456,1.93
 2019,Humboldt,NV,"Humboldt, NV",47967,0,1051,45043,2924,1.06
 2020,Humboldt,NV,"Humboldt, NV",50801,6,1345,57643,-6842,0.88
 2021,Humboldt,NV,"Humboldt, NV",53564,5,1649,70671,-17107,0.76
 2019,Humphreys,MS,"Humphreys, MS",34551,0,291,12471,22080,2.77
 2020,Humphreys,MS,"Humphreys, MS",39903,16,530,22714,17189,1.76
 2021,Humphreys,MS,"Humphreys, MS",43981,10,479,20529,23452,2.14
 2019,Humphreys,TN,"Humphreys, TN",39322,0,1053,45129,-5807,0.87
 2020,Humphreys,TN,"Humphreys, TN",41538,6,1053,45129,-3591,0.92
 2021,Humphreys,TN,"Humphreys, TN",44127,6,1746,74829,-30702,0.59
 2019,Hunt,TX,"Hunt, TX",40828,0,1014,43457,-2629,0.94
 2020,Hunt,TX,"Hunt, TX",43345,6,1071,45900,-2555,0.94
 2021,Hunt,TX,"Hunt, TX",46801,8,1115,47786,-985,0.98
 2019,Hunterdon,NJ,"Hunterdon, NJ",90649,0,2185,93643,-2994,0.97
 2020,Hunterdon,NJ,"Hunterdon, NJ",93279,3,2323,99557,-6278,0.94
 2021,Hunterdon,NJ,"Hunterdon, NJ",100288,8,2661,114043,-13755,0.88
 2019,Huntingdon,PA,"Huntingdon, PA",39855,0,680,29143,10712,1.37
 2020,Huntingdon,PA,"Huntingdon, PA",44087,11,699,29957,14130,1.47
 2021,Huntingdon,PA,"Huntingdon, PA",46331,5,973,41700,4631,1.11
 2019,Huntington,IN,"Huntington, IN",42151,0,625,26786,15365,1.57
 2020,Huntington,IN,"Huntington, IN",45486,8,497,21300,24186,2.14
 2021,Huntington,IN,"Huntington, IN",49571,9,550,23571,26000,2.1
 2019,Huron,MI,"Huron, MI",45222,0,651,27900,17322,1.62
 2020,Huron,MI,"Huron, MI",52150,15,671,28757,23393,1.81
 2021,Huron,MI,"Huron, MI",55774,7,783,33557,22217,1.66
 2019,Huron,OH,"Huron, OH",40967,0,594,25457,15510,1.61
 2020,Huron,OH,"Huron, OH",44947,10,631,27043,17904,1.66
 2021,Huron,OH,"Huron, OH",48213,7,695,29786,18427,1.62
 2019,Hutchinson,SD,"Hutchinson, SD",56256,0,646,27686,28570,2.03
 2020,Hutchinson,SD,"Hutchinson, SD",58623,4,724,31029,27594,1.89
 2021,Hutchinson,SD,"Hutchinson, SD",65945,13,790,33857,32088,1.95
 2019,Hutchinson,TX,"Hutchinson, TX",43542,0,425,18214,25328,2.39
 2020,Hutchinson,TX,"Hutchinson, TX",46443,7,326,13971,32472,3.32
 2021,Hutchinson,TX,"Hutchinson, TX",50130,8,569,24386,25744,2.06
 2019,Hyde,NC,"Hyde, NC",42537,0,1738,74486,-31949,0.57
 2020,Hyde,NC,"Hyde, NC",45957,8,1757,75300,-29343,0.61
 2021,Hyde,NC,"Hyde, NC",49175,7,2042,87514,-38339,0.56
 2020,Hyde,SD,"Hyde, SD",63924,31,1319,56529,7395,1.13
 2021,Hyde,SD,"Hyde, SD",70095,10,719,30814,39281,2.27
 2019,Iberia,LA,"Iberia, LA",40679,0,673,28843,11836,1.41
 2020,Iberia,LA,"Iberia, LA",43961,8,648,27771,16190,1.58
 2021,Iberia,LA,"Iberia, LA",47594,8,844,36171,11423,1.32
 2019,Iberville,LA,"Iberville, LA",45244,0,1008,43200,2044,1.05
 2020,Iberville,LA,"Iberville, LA",49075,9,1001,42900,6175,1.14
 2021,Iberville,LA,"Iberville, LA",52930,8,999,42814,10116,1.24
 2019,Ida,IA,"Ida, IA",51541,0,550,23571,27970,2.19
 2020,Ida,IA,"Ida, IA",57586,12,491,21043,36543,2.74
 2021,Ida,IA,"Ida, IA",65824,14,543,23271,42553,2.83
 2019,Idaho,ID,"Idaho, ID",35784,0,1367,58586,-22802,0.61
 2020,Idaho,ID,"Idaho, ID",39404,10,1814,77743,-38339,0.51
 2021,Idaho,ID,"Idaho, ID",41484,5,1968,84343,-42859,0.49
 2019,Imperial,CA,"Imperial, CA",37904,0,1168,50057,-12153,0.76
 2020,Imperial,CA,"Imperial, CA",45021,19,1247,53443,-8422,0.84
 2021,Imperial,CA,"Imperial, CA",47653,6,1338,57343,-9690,0.83
 2019,Independence,AR,"Independence, AR",36060,0,743,31843,4217,1.13
 2020,Independence,AR,"Independence, AR",38631,7,843,36129,2502,1.07
 2021,Independence,AR,"Independence, AR",42120,9,824,35314,6806,1.19
 2019,Indian River,FL,"Indian River, FL",86856,0,1657,71014,15842,1.22
 2020,Indian River,FL,"Indian River, FL",89294,3,1629,69814,19480,1.28
 2021,Indian River,FL,"Indian River, FL",95109,7,1972,84514,10595,1.13
 2019,Indiana,PA,"Indiana, PA",41489,0,629,26957,14532,1.54
 2020,Indiana,PA,"Indiana, PA",44804,8,579,24814,19990,1.81
 2021,Indiana,PA,"Indiana, PA",47945,7,599,25671,22274,1.87
 2019,Ingham,MI,"Ingham, MI",42183,0,629,26957,15226,1.56
 2020,Ingham,MI,"Ingham, MI",46669,11,592,25371,21298,1.84
 2021,Ingham,MI,"Ingham, MI",49608,6,607,26014,23594,1.91
 2019,Inyo,CA,"Inyo, CA",58351,0,2020,86571,-28220,0.67
 2020,Inyo,CA,"Inyo, CA",60124,3,1978,84771,-24647,0.71
 2021,Inyo,CA,"Inyo, CA",62090,3,2206,94543,-32453,0.66
 2019,Ionia,MI,"Ionia, MI",34416,0,762,32657,1759,1.05
 2020,Ionia,MI,"Ionia, MI",38396,12,769,32957,5439,1.17
 2021,Ionia,MI,"Ionia, MI",40849,6,890,38143,2706,1.07
 2019,Iosco,MI,"Iosco, MI",39258,0,492,21086,18172,1.86
 2020,Iosco,MI,"Iosco, MI",44079,12,646,27686,16393,1.59
 2021,Iosco,MI,"Iosco, MI",46918,6,796,34114,12804,1.38
 2019,Iowa,IA,"Iowa, IA",53104,0,645,27643,25461,1.92
 2020,Iowa,IA,"Iowa, IA",56741,7,871,37329,19412,1.52
 2021,Iowa,IA,"Iowa, IA",62485,10,751,32186,30299,1.94
 2019,Iowa,WI,"Iowa, WI",50155,0,1156,49543,612,1.01
 2020,Iowa,WI,"Iowa, WI",53878,7,1280,54857,-979,0.98
 2021,Iowa,WI,"Iowa, WI",57445,7,1292,55371,2074,1.04
 2019,Iredell,NC,"Iredell, NC",53430,0,1596,68400,-14970,0.78
 2020,Iredell,NC,"Iredell, NC",56830,6,1712,73371,-16541,0.77
 2021,Iredell,NC,"Iredell, NC",60791,7,2093,89700,-28909,0.68
 2019,Irion,TX,"Irion, TX",73308,0,1008,43200,30108,1.7
 2020,Irion,TX,"Irion, TX",72474,-1,1201,51471,21003,1.41
 2021,Irion,TX,"Irion, TX",78988,9,1106,47400,31588,1.67
 2019,Iron,MI,"Iron, MI",44218,0,589,25243,18975,1.75
 2020,Iron,MI,"Iron, MI",47339,7,601,25757,21582,1.84
 2021,Iron,MI,"Iron, MI",49653,5,771,33043,16610,1.5
 2019,Iron,MO,"Iron, MO",35263,0,438,18771,16492,1.88
 2020,Iron,MO,"Iron, MO",38593,9,463,19843,18750,1.94
 2021,Iron,MO,"Iron, MO",41182,7,551,23614,17568,1.74
 2019,Iron,UT,"Iron, UT",33840,0,1235,52929,-19089,0.64
 2020,Iron,UT,"Iron, UT",36533,8,1332,57086,-20553,0.64
 2021,Iron,UT,"Iron, UT",38834,6,2028,86914,-48080,0.45
 2019,Iron,WI,"Iron, WI",47623,0,816,34971,12652,1.36
 2020,Iron,WI,"Iron, WI",50558,6,936,40114,10444,1.26
 2021,Iron,WI,"Iron, WI",52673,4,895,38357,14316,1.37
 2019,Iroquois,IL,"Iroquois, IL",44055,0,443,18986,25069,2.32
 2020,Iroquois,IL,"Iroquois, IL",50377,14,472,20229,30148,2.49
 2021,Iroquois,IL,"Iroquois, IL",56185,12,608,26057,30128,2.16
 2019,Irwin,GA,"Irwin, GA",34392,0,472,20229,14163,1.7
 2020,Irwin,GA,"Irwin, GA",37925,10,432,18514,19411,2.05
 2021,Irwin,GA,"Irwin, GA",40963,8,952,40800,163,1
 2019,Isabella,MI,"Isabella, MI",39018,0,732,31371,7647,1.24
 2020,Isabella,MI,"Isabella, MI",43582,12,841,36043,7539,1.21
 2021,Isabella,MI,"Isabella, MI",45657,5,781,33471,12186,1.36
 2019,Isanti,MN,"Isanti, MN",46713,0,1205,51643,-4930,0.9
 2020,Isanti,MN,"Isanti, MN",49721,6,1202,51514,-1793,0.97
 2021,Isanti,MN,"Isanti, MN",53189,7,1520,65143,-11954,0.82
 2019,Isle Of Wight,VA,"Isle Of Wight, VA",55640,0,1674,71743,-16103,0.78
 2020,Isle Of Wight,VA,"Isle Of Wight, VA",58819,6,1697,72729,-13910,0.81
 2021,Isle Of Wight,VA,"Isle Of Wight, VA",63005,7,1826,78257,-15252,0.81
 2019,Issaquena,MS,"Issaquena, MS",24805,0,253,10843,13962,2.29
 2020,Issaquena,MS,"Issaquena, MS",32026,29,427,18300,13726,1.75
 2021,Issaquena,MS,"Issaquena, MS",34832,9,76,3257,31575,10.69
 2019,Itasca,MN,"Itasca, MN",45393,0,853,36557,8836,1.24
 2020,Itasca,MN,"Itasca, MN",48240,6,832,35657,12583,1.35
 2021,Itasca,MN,"Itasca, MN",51563,7,1000,42857,8706,1.2
 2019,Itawamba,MS,"Itawamba, MS",35790,0,711,30471,5319,1.17
 2020,Itawamba,MS,"Itawamba, MS",39016,9,753,32271,6745,1.21
 2021,Itawamba,MS,"Itawamba, MS",41579,7,897,38443,3136,1.08
 2019,Izard,AR,"Izard, AR",30885,0,644,27600,3285,1.12
 2020,Izard,AR,"Izard, AR",33061,7,628,26914,6147,1.23
 2021,Izard,AR,"Izard, AR",34986,6,886,37971,-2985,0.92
 2019,Jack,TX,"Jack, TX",42127,0,633,27129,14998,1.55
 2020,Jack,TX,"Jack, TX",43260,3,541,23186,20074,1.87
 2021,Jack,TX,"Jack, TX",45263,5,991,42471,2792,1.07
 2019,Jackson,AL,"Jackson, AL",37180,0,801,34329,2851,1.08
 2020,Jackson,AL,"Jackson, AL",39664,7,906,38829,835,1.02
 2021,Jackson,AL,"Jackson, AL",43565,10,1199,51386,-7821,0.85
 2019,Jackson,AR,"Jackson, AR",37858,0,312,13371,24487,2.83
 2020,Jackson,AR,"Jackson, AR",42541,12,347,14871,27670,2.86
 2021,Jackson,AR,"Jackson, AR",42871,1,368,15771,27100,2.72
 2019,Jackson,CO,"Jackson, CO",54569,0,1206,51686,2883,1.06
 2020,Jackson,CO,"Jackson, CO",58270,7,1437,61586,-3316,0.95
 2021,Jackson,CO,"Jackson, CO",62823,8,1518,65057,-2234,0.97
 2019,Jackson,FL,"Jackson, FL",34518,0,734,31457,3061,1.1
 2020,Jackson,FL,"Jackson, FL",36810,7,711,30471,6339,1.21
 2021,Jackson,FL,"Jackson, FL",39322,7,964,41314,-1992,0.95
 2019,Jackson,GA,"Jackson, GA",43894,0,1362,58371,-14477,0.75
 2020,Jackson,GA,"Jackson, GA",45903,5,1365,58500,-12597,0.78
 2021,Jackson,GA,"Jackson, GA",49063,7,2039,87386,-38323,0.56
 2019,Jackson,IA,"Jackson, IA",45647,0,762,32657,12990,1.4
 2020,Jackson,IA,"Jackson, IA",49345,8,906,38829,10516,1.27
 2021,Jackson,IA,"Jackson, IA",53777,9,753,32271,21506,1.67
 2019,Jackson,IL,"Jackson, IL",39719,0,483,20700,19019,1.92
 2020,Jackson,IL,"Jackson, IL",43023,8,452,19371,23652,2.22
 2021,Jackson,IL,"Jackson, IL",46443,8,398,17057,29386,2.72
 2019,Jackson,IN,"Jackson, IN",42316,0,631,27043,15273,1.56
 2020,Jackson,IN,"Jackson, IN",45605,8,860,36857,8748,1.24
 2021,Jackson,IN,"Jackson, IN",49451,8,833,35700,13751,1.39
 2019,Jackson,KS,"Jackson, KS",43615,0,757,32443,11172,1.34
 2020,Jackson,KS,"Jackson, KS",47644,9,827,35443,12201,1.34
 2021,Jackson,KS,"Jackson, KS",50620,6,1000,42857,7763,1.18
 2019,Jackson,KY,"Jackson, KY",30843,0,462,19800,11043,1.56
 2020,Jackson,KY,"Jackson, KY",34343,11,481,20614,13729,1.67
 2021,Jackson,KY,"Jackson, KY",38055,11,1134,48600,-10545,0.78
 2019,Jackson,LA,"Jackson, LA",35609,0,883,37843,-2234,0.94
 2020,Jackson,LA,"Jackson, LA",39074,10,907,38871,203,1.01
 2021,Jackson,LA,"Jackson, LA",43272,11,699,29957,13315,1.44
 2019,Jackson,MI,"Jackson, MI",39775,0,697,29871,9904,1.33
 2020,Jackson,MI,"Jackson, MI",44152,11,711,30471,13681,1.45
 2021,Jackson,MI,"Jackson, MI",47503,8,768,32914,14589,1.44
 2019,Jackson,MN,"Jackson, MN",52652,0,574,24600,28052,2.14
 2020,Jackson,MN,"Jackson, MN",60415,15,615,26357,34058,2.29
 2021,Jackson,MN,"Jackson, MN",63311,5,648,27771,35540,2.28
 2019,Jackson,MO,"Jackson, MO",46644,0,1062,45514,1130,1.02
 2020,Jackson,MO,"Jackson, MO",49915,7,1190,51000,-1085,0.98
 2021,Jackson,MO,"Jackson, MO",53112,6,1255,53786,-674,0.99
 2019,Jackson,MS,"Jackson, MS",38894,0,799,34243,4651,1.14
 2020,Jackson,MS,"Jackson, MS",42163,8,808,34629,7534,1.22
 2021,Jackson,MS,"Jackson, MS",44945,7,865,37071,7874,1.21
 2019,Jackson,NC,"Jackson, NC",36736,0,2114,90600,-53864,0.41
 2020,Jackson,NC,"Jackson, NC",39950,9,2005,85929,-45979,0.46
 2021,Jackson,NC,"Jackson, NC",43362,9,3225,138214,-94852,0.31
 2019,Jackson,OH,"Jackson, OH",36620,0,562,24086,12534,1.52
 2020,Jackson,OH,"Jackson, OH",40658,11,573,24557,16101,1.66
 2021,Jackson,OH,"Jackson, OH",42680,5,731,31329,11351,1.36
 2019,Jackson,OK,"Jackson, OK",42542,0,664,28457,14085,1.49
 2020,Jackson,OK,"Jackson, OK",45539,7,529,22671,22868,2.01
 2021,Jackson,OK,"Jackson, OK",49372,8,793,33986,15386,1.45
 2019,Jackson,OR,"Jackson, OR",47774,0,1932,82800,-35026,0.58
 2020,Jackson,OR,"Jackson, OR",52410,10,2004,85886,-33476,0.61
 2021,Jackson,OR,"Jackson, OR",56842,9,2402,102943,-46101,0.55
 2019,Jackson,SD,"Jackson, SD",30066,0,418,17914,12152,1.68
 2020,Jackson,SD,"Jackson, SD",35221,17,617,26443,8778,1.33
 2021,Jackson,SD,"Jackson, SD",39102,11,16081,689186,-650084,0.06
 2019,Jackson,TN,"Jackson, TN",33366,0,897,38443,-5077,0.87
 2020,Jackson,TN,"Jackson, TN",36084,8,777,33300,2784,1.08
 2021,Jackson,TN,"Jackson, TN",38953,8,1401,60043,-21090,0.65
 2019,Jackson,TX,"Jackson, TX",47992,0,901,38614,9378,1.24
 2020,Jackson,TX,"Jackson, TX",47949,0,979,41957,5992,1.14
 2021,Jackson,TX,"Jackson, TX",51971,8,1194,51171,800,1.02
 2019,Jackson,WI,"Jackson, WI",44994,0,697,29871,15123,1.51
 2020,Jackson,WI,"Jackson, WI",48041,7,781,33471,14570,1.44
 2021,Jackson,WI,"Jackson, WI",49697,3,1104,47314,2383,1.05
 2019,Jackson,WV,"Jackson, WV",40190,0,784,33600,6590,1.2
 2020,Jackson,WV,"Jackson, WV",42681,6,739,31671,11010,1.35
 2021,Jackson,WV,"Jackson, WV",45681,7,874,37457,8224,1.22
 2019,Jasper,GA,"Jasper, GA",39331,0,1226,52543,-13212,0.75
 2020,Jasper,GA,"Jasper, GA",41228,5,1338,57343,-16115,0.72
 2021,Jasper,GA,"Jasper, GA",44317,8,1600,68571,-24254,0.65
 2019,Jasper,IA,"Jasper, IA",43206,0,763,32700,10506,1.32
 2020,Jasper,IA,"Jasper, IA",46341,7,747,32014,14327,1.45
 2021,Jasper,IA,"Jasper, IA",50190,8,721,30900,19290,1.62
 2019,Jasper,IL,"Jasper, IL",42118,0,458,19629,22489,2.15
 2020,Jasper,IL,"Jasper, IL",48543,15,426,18257,30286,2.66
 2021,Jasper,IL,"Jasper, IL",54032,11,392,16800,37232,3.22
 2019,Jasper,IN,"Jasper, IN",45885,0,833,35700,10185,1.29
 2020,Jasper,IN,"Jasper, IN",50378,10,1049,44957,5421,1.12
 2021,Jasper,IN,"Jasper, IN",55018,9,1217,52157,2861,1.05
 2019,Jasper,MO,"Jasper, MO",39842,0,686,29400,10442,1.36
 2020,Jasper,MO,"Jasper, MO",41265,4,671,28757,12508,1.43
 2021,Jasper,MO,"Jasper, MO",43859,6,903,38700,5159,1.13
 2019,Jasper,MS,"Jasper, MS",41047,0,743,31843,9204,1.29
 2020,Jasper,MS,"Jasper, MS",41334,1,780,33429,7905,1.24
 2021,Jasper,MS,"Jasper, MS",46041,11,714,30600,15441,1.5
 2019,Jasper,SC,"Jasper, SC",35901,0,1212,51943,-16042,0.69
 2020,Jasper,SC,"Jasper, SC",39314,10,1505,64500,-25186,0.61
 2021,Jasper,SC,"Jasper, SC",41531,6,1752,75086,-33555,0.55
 2019,Jasper,TX,"Jasper, TX",44267,0,732,31371,12896,1.41
 2020,Jasper,TX,"Jasper, TX",46809,6,840,36000,10809,1.3
 2021,Jasper,TX,"Jasper, TX",49475,6,1211,51900,-2425,0.95
 2019,Jay,IN,"Jay, IN",37476,0,339,14529,22947,2.58
 2020,Jay,IN,"Jay, IN",42428,13,375,16071,26357,2.64
 2021,Jay,IN,"Jay, IN",49300,16,450,19286,30014,2.56
 2019,Jeff Davis,GA,"Jeff Davis, GA",32980,0,515,22071,10909,1.49
 2020,Jeff Davis,GA,"Jeff Davis, GA",35826,9,379,16243,19583,2.21
 2021,Jeff Davis,GA,"Jeff Davis, GA",38122,6,1357,58157,-20035,0.66
 2019,Jeff Davis,TX,"Jeff Davis, TX",49532,0,1415,60643,-11111,0.82
 2020,Jeff Davis,TX,"Jeff Davis, TX",53670,8,1355,58071,-4401,0.92
 2021,Jeff Davis,TX,"Jeff Davis, TX",59302,11,1473,63129,-3827,0.94
 2019,Jefferson Davis,LA,"Jefferson Davis, LA",42421,0,714,30600,11821,1.39
 2020,Jefferson Davis,LA,"Jefferson Davis, LA",45304,7,665,28500,16804,1.59
 2021,Jefferson Davis,LA,"Jefferson Davis, LA",46922,4,939,40243,6679,1.17
 2019,Jefferson Davis,MS,"Jefferson Davis, MS",29943,0,838,35914,-5971,0.83
 2020,Jefferson Davis,MS,"Jefferson Davis, MS",32452,8,399,17100,15352,1.9
 2021,Jefferson Davis,MS,"Jefferson Davis, MS",36241,12,366,15686,20555,2.31
 2019,Jefferson,AL,"Jefferson, AL",55052,0,973,41700,13352,1.32
 2020,Jefferson,AL,"Jefferson, AL",58053,6,1117,47871,10182,1.21
 2021,Jefferson,AL,"Jefferson, AL",62371,7,1079,46243,16128,1.35
 2019,Jefferson,AR,"Jefferson, AR",34843,0,428,18343,16500,1.9
 2020,Jefferson,AR,"Jefferson, AR",38571,11,375,16071,22500,2.4
 2021,Jefferson,AR,"Jefferson, AR",42076,9,484,20743,21333,2.03
 2019,Jefferson,CO,"Jefferson, CO",66571,0,2557,109586,-43015,0.61
 2020,Jefferson,CO,"Jefferson, CO",69118,4,2949,126386,-57268,0.55
 2021,Jefferson,CO,"Jefferson, CO",74822,8,3045,130500,-55678,0.57
 2019,Jefferson,FL,"Jefferson, FL",43672,0,1205,51643,-7971,0.85
 2020,Jefferson,FL,"Jefferson, FL",45771,5,1266,54257,-8486,0.84
 2021,Jefferson,FL,"Jefferson, FL",50197,10,1459,62529,-12332,0.8
 2019,Jefferson,GA,"Jefferson, GA",34020,0,1004,43029,-9009,0.79
 2020,Jefferson,GA,"Jefferson, GA",38396,13,752,32229,6167,1.19
 2021,Jefferson,GA,"Jefferson, GA",43720,14,1507,64586,-20866,0.68
 2019,Jefferson,IA,"Jefferson, IA",47875,0,687,29443,18432,1.63
 2020,Jefferson,IA,"Jefferson, IA",50955,6,732,31371,19584,1.62
 2021,Jefferson,IA,"Jefferson, IA",55900,10,1054,45171,10729,1.24
 2019,Jefferson,ID,"Jefferson, ID",37847,0,1425,61071,-23224,0.62
 2020,Jefferson,ID,"Jefferson, ID",39949,6,1611,69043,-29094,0.58
 2021,Jefferson,ID,"Jefferson, ID",42307,6,2438,104486,-62179,0.4
 2019,Jefferson,IL,"Jefferson, IL",40279,0,522,22371,17908,1.8
 2020,Jefferson,IL,"Jefferson, IL",44355,10,603,25843,18512,1.72
 2021,Jefferson,IL,"Jefferson, IL",48057,8,681,29186,18871,1.65
 2019,Jefferson,IN,"Jefferson, IN",43626,0,846,36257,7369,1.2
 2020,Jefferson,IN,"Jefferson, IN",47176,8,737,31586,15590,1.49
 2021,Jefferson,IN,"Jefferson, IN",50734,8,1032,44229,6505,1.15
 2019,Jefferson,KS,"Jefferson, KS",46591,0,858,36771,9820,1.27
 2020,Jefferson,KS,"Jefferson, KS",49792,7,786,33686,16106,1.48
 2021,Jefferson,KS,"Jefferson, KS",52892,6,890,38143,14749,1.39
 2019,Jefferson,KY,"Jefferson, KY",53360,0,1280,54857,-1497,0.97
 2020,Jefferson,KY,"Jefferson, KY",57290,7,1229,52671,4619,1.09
 2021,Jefferson,KY,"Jefferson, KY",61474,7,1115,47786,13688,1.29
 2019,Jefferson,LA,"Jefferson, LA",51166,0,1185,50786,380,1.01
 2020,Jefferson,LA,"Jefferson, LA",54927,7,1251,53614,1313,1.02
 2021,Jefferson,LA,"Jefferson, LA",58284,6,1513,64843,-6559,0.9
 2019,Jefferson,MO,"Jefferson, MO",44193,0,992,42514,1679,1.04
 2020,Jefferson,MO,"Jefferson, MO",46665,6,1104,47314,-649,0.99
 2021,Jefferson,MO,"Jefferson, MO",49392,6,1232,52800,-3408,0.94
 2019,Jefferson,MS,"Jefferson, MS",33929,0,270,11571,22358,2.93
 2020,Jefferson,MS,"Jefferson, MS",37139,10,1032,44229,-7090,0.84
 2021,Jefferson,MS,"Jefferson, MS",40349,9,3154,135171,-94822,0.3
 2019,Jefferson,MT,"Jefferson, MT",51121,0,1703,72986,-21865,0.7
 2020,Jefferson,MT,"Jefferson, MT",54195,6,1813,77700,-23505,0.7
 2021,Jefferson,MT,"Jefferson, MT",56632,5,2993,128271,-71639,0.44
 2019,Jefferson,NE,"Jefferson, NE",48162,0,444,19029,29133,2.53
 2020,Jefferson,NE,"Jefferson, NE",52524,9,426,18257,34267,2.88
 2021,Jefferson,NE,"Jefferson, NE",56274,7,785,33643,22631,1.67
 2019,Jefferson,NY,"Jefferson, NY",45905,0,795,34071,11834,1.35
 2020,Jefferson,NY,"Jefferson, NY",50368,10,784,33600,16768,1.5
 2021,Jefferson,NY,"Jefferson, NY",53130,6,808,34629,18501,1.53
 2019,Jefferson,OH,"Jefferson, OH",40616,0,413,17700,22916,2.29
 2020,Jefferson,OH,"Jefferson, OH",44238,9,454,19457,24781,2.27
 2021,Jefferson,OH,"Jefferson, OH",47413,7,621,26614,20799,1.78
 2019,Jefferson,OK,"Jefferson, OK",37175,0,345,14786,22389,2.51
 2020,Jefferson,OK,"Jefferson, OK",40359,9,714,30600,9759,1.32
 2021,Jefferson,OK,"Jefferson, OK",41152,2,593,25414,15738,1.62
 2019,Jefferson,OR,"Jefferson, OR",36078,0,1300,55714,-19636,0.65
 2020,Jefferson,OR,"Jefferson, OR",39948,11,1538,65914,-25966,0.61
 2021,Jefferson,OR,"Jefferson, OR",43145,8,1898,81343,-38198,0.53
 2019,Jefferson,PA,"Jefferson, PA",43852,0,450,19286,24566,2.27
 2020,Jefferson,PA,"Jefferson, PA",47510,8,418,17914,29596,2.65
 2021,Jefferson,PA,"Jefferson, PA",50240,6,640,27429,22811,1.83
 2019,Jefferson,TN,"Jefferson, TN",38765,0,1270,54429,-15664,0.71
 2020,Jefferson,TN,"Jefferson, TN",41324,7,1287,55157,-13833,0.75
 2021,Jefferson,TN,"Jefferson, TN",44330,7,1934,82886,-38556,0.53
 2019,Jefferson,TX,"Jefferson, TX",43650,0,852,36514,7136,1.2
 2020,Jefferson,TX,"Jefferson, TX",45749,5,893,38271,7478,1.2
 2021,Jefferson,TX,"Jefferson, TX",48243,6,972,41657,6586,1.16
 2019,Jefferson,WA,"Jefferson, WA",54524,0,2291,98186,-43662,0.56
 2020,Jefferson,WA,"Jefferson, WA",57847,6,2274,97457,-39610,0.59
 2021,Jefferson,WA,"Jefferson, WA",60365,4,2926,125400,-65035,0.48
 2019,Jefferson,WI,"Jefferson, WI",47726,0,1280,54857,-7131,0.87
 2020,Jefferson,WI,"Jefferson, WI",50624,6,1303,55843,-5219,0.91
 2021,Jefferson,WI,"Jefferson, WI",53863,6,1376,58971,-5108,0.91
 2019,Jefferson,WV,"Jefferson, WV",53184,0,1419,60814,-7630,0.87
 2020,Jefferson,WV,"Jefferson, WV",55879,5,1476,63257,-7378,0.88
 2021,Jefferson,WV,"Jefferson, WV",59214,6,1848,79200,-19986,0.75
 2019,Jenkins,GA,"Jenkins, GA",30946,0,511,21900,9046,1.41
 2020,Jenkins,GA,"Jenkins, GA",34673,12,665,28500,6173,1.22
 2021,Jenkins,GA,"Jenkins, GA",36886,6,1013,43414,-6528,0.85
 2019,Jennings,IN,"Jennings, IN",41278,0,667,28586,12692,1.44
 2020,Jennings,IN,"Jennings, IN",44993,9,650,27857,17136,1.62
 2021,Jennings,IN,"Jennings, IN",49519,10,756,32400,17119,1.53
 2019,Jerauld,SD,"Jerauld, SD",42449,0,451,19329,23120,2.2
 2020,Jerauld,SD,"Jerauld, SD",54371,28,412,17657,36714,3.08
 2021,Jerauld,SD,"Jerauld, SD",62655,15,781,33471,29184,1.87
 2019,Jerome,ID,"Jerome, ID",38333,0,991,42471,-4138,0.9
 2020,Jerome,ID,"Jerome, ID",41646,9,1053,45129,-3483,0.92
 2021,Jerome,ID,"Jerome, ID",42356,2,1960,84000,-41644,0.5
 2019,Jersey,IL,"Jersey, IL",43093,0,634,27171,15922,1.59
 2020,Jersey,IL,"Jersey, IL",47107,9,658,28200,18907,1.67
 2021,Jersey,IL,"Jersey, IL",50874,8,819,35100,15774,1.45
 2019,Jessamine,KY,"Jessamine, KY",48173,0,1426,61114,-12941,0.79
 2020,Jessamine,KY,"Jessamine, KY",51543,7,1391,59614,-8071,0.86
 2021,Jessamine,KY,"Jessamine, KY",55040,7,1818,77914,-22874,0.71
 2019,Jewell,KS,"Jewell, KS",48311,0,644,27600,20711,1.75
 2020,Jewell,KS,"Jewell, KS",56799,18,457,19586,37213,2.9
 2021,Jewell,KS,"Jewell, KS",60881,7,1010,43286,17595,1.41
 2019,Jim Hogg,TX,"Jim Hogg, TX",36197,0,512,21943,14254,1.65
 2020,Jim Hogg,TX,"Jim Hogg, TX",39153,8,505,21643,17510,1.81
 2021,Jim Hogg,TX,"Jim Hogg, TX",43336,11,395,16929,26407,2.56
 2019,Jim Wells,TX,"Jim Wells, TX",43512,0,720,30857,12655,1.41
 2020,Jim Wells,TX,"Jim Wells, TX",47267,9,862,36943,10324,1.28
 2021,Jim Wells,TX,"Jim Wells, TX",50892,8,844,36171,14721,1.41
 2019,Jo Daviess,IL,"Jo Daviess, IL",47991,0,1000,42857,5134,1.12
 2020,Jo Daviess,IL,"Jo Daviess, IL",52229,9,993,42557,9672,1.23
 2021,Jo Daviess,IL,"Jo Daviess, IL",56428,8,1335,57214,-786,0.99
 2019,Johnson,AR,"Johnson, AR",29625,0,711,30471,-846,0.97
 2020,Johnson,AR,"Johnson, AR",31779,7,648,27771,4008,1.14
 2021,Johnson,AR,"Johnson, AR",35577,12,665,28500,7077,1.25
 2019,Johnson,GA,"Johnson, GA",27166,0,527,22586,4580,1.2
 2020,Johnson,GA,"Johnson, GA",30333,12,378,16200,14133,1.87
 2021,Johnson,GA,"Johnson, GA",33265,10,522,22371,10894,1.49
 2019,Johnson,IA,"Johnson, IA",54734,0,1376,58971,-4237,0.93
 2020,Johnson,IA,"Johnson, IA",57009,4,1338,57343,-334,0.99
 2021,Johnson,IA,"Johnson, IA",59592,5,1529,65529,-5937,0.91
 2019,Johnson,IL,"Johnson, IL",34768,0,834,35743,-975,0.97
 2020,Johnson,IL,"Johnson, IL",37515,8,795,34071,3444,1.1
 2021,Johnson,IL,"Johnson, IL",40166,7,781,33471,6695,1.2
 2019,Johnson,IN,"Johnson, IN",50351,0,1256,53829,-3478,0.94
 2020,Johnson,IN,"Johnson, IN",53112,6,1357,58157,-5045,0.91
 2021,Johnson,IN,"Johnson, IN",56808,7,1515,64929,-8121,0.87
 2019,Johnson,KS,"Johnson, KS",78728,0,2094,89743,-11015,0.88
 2020,Johnson,KS,"Johnson, KS",81020,3,2265,97071,-16051,0.83
 2021,Johnson,KS,"Johnson, KS",84535,4,2471,105900,-21365,0.8
 2019,Johnson,KY,"Johnson, KY",33813,0,615,26357,7456,1.28
 2020,Johnson,KY,"Johnson, KY",37208,10,495,21214,15994,1.75
 2021,Johnson,KY,"Johnson, KY",41110,11,583,24986,16124,1.65
 2019,Johnson,MO,"Johnson, MO",37599,0,866,37114,485,1.01
 2020,Johnson,MO,"Johnson, MO",40141,7,931,39900,241,1.01
 2021,Johnson,MO,"Johnson, MO",46526,16,1177,50443,-3917,0.92
 2019,Johnson,NE,"Johnson, NE",34566,0,378,16200,18366,2.13
 2020,Johnson,NE,"Johnson, NE",38725,12,622,26657,12068,1.45
 2021,Johnson,NE,"Johnson, NE",42104,9,641,27471,14633,1.53
 2019,Johnson,TN,"Johnson, TN",33282,0,959,41100,-7818,0.81
 2020,Johnson,TN,"Johnson, TN",35623,7,1297,55586,-19963,0.64
 2021,Johnson,TN,"Johnson, TN",37936,7,1608,68914,-30978,0.55
 2019,Johnson,TX,"Johnson, TX",45041,0,1432,61371,-16330,0.73
 2020,Johnson,TX,"Johnson, TX",47724,6,1405,60214,-12490,0.79
 2021,Johnson,TX,"Johnson, TX",51619,8,1862,79800,-28181,0.65
 2019,Johnson,WY,"Johnson, WY",56585,0,1372,58800,-2215,0.96
 2020,Johnson,WY,"Johnson, WY",58260,3,1520,65143,-6883,0.89
 2021,Johnson,WY,"Johnson, WY",61294,5,1918,82200,-20906,0.75
 2019,Johnston,NC,"Johnston, NC",42117,0,1299,55671,-13554,0.76
 2020,Johnston,NC,"Johnston, NC",45109,7,1283,54986,-9877,0.82
 2021,Johnston,NC,"Johnston, NC",48950,9,1737,74443,-25493,0.66
 2019,Johnston,OK,"Johnston, OK",37159,0,606,25971,11188,1.43
 2020,Johnston,OK,"Johnston, OK",40616,9,685,29357,11259,1.38
 2021,Johnston,OK,"Johnston, OK",43246,7,1197,51300,-8054,0.84
 2019,Jones,GA,"Jones, GA",39009,0,813,34843,4166,1.12
 2020,Jones,GA,"Jones, GA",41573,7,925,39643,1930,1.05
 2021,Jones,GA,"Jones, GA",44704,8,1095,46929,-2225,0.95
 2019,Jones,IA,"Jones, IA",45074,0,719,30814,14260,1.46
 2020,Jones,IA,"Jones, IA",48104,7,860,36857,11247,1.31
 2021,Jones,IA,"Jones, IA",51576,7,793,33986,17590,1.52
 2019,Jones,MS,"Jones, MS",39102,0,680,29143,9959,1.34
 2020,Jones,MS,"Jones, MS",41022,5,758,32486,8536,1.26
 2021,Jones,MS,"Jones, MS",44494,9,976,41829,2665,1.06
 2019,Jones,NC,"Jones, NC",42088,0,614,26314,15774,1.6
 2020,Jones,NC,"Jones, NC",43579,4,807,34586,8993,1.26
 2021,Jones,NC,"Jones, NC",50245,15,925,39643,10602,1.27
 2019,Jones,SD,"Jones, SD",55122,0,719,30814,24308,1.79
 2020,Jones,SD,"Jones, SD",57309,4,863,36986,20323,1.55
 2021,Jones,SD,"Jones, SD",86307,51,544,23314,62993,3.7
 2019,Jones,TX,"Jones, TX",33876,0,506,21686,12190,1.56
 2020,Jones,TX,"Jones, TX",35575,5,610,26143,9432,1.36
 2021,Jones,TX,"Jones, TX",38914,9,689,29529,9385,1.32
 2019,Josephine,OR,"Josephine, OR",44048,0,1631,69900,-25852,0.63
 2020,Josephine,OR,"Josephine, OR",49062,11,1824,78171,-29109,0.63
 2021,Josephine,OR,"Josephine, OR",54466,11,1827,78300,-23834,0.7
 2019,Juab,UT,"Juab, UT",39419,0,1524,65314,-25895,0.6
 2020,Juab,UT,"Juab, UT",43485,10,1760,75429,-31944,0.58
 2021,Juab,UT,"Juab, UT",48060,11,1794,76886,-28826,0.63
 2019,Judith Basin,MT,"Judith Basin, MT",48136,0,589,25243,22893,1.91
 2020,Judith Basin,MT,"Judith Basin, MT",52026,8,536,22971,29055,2.26
 2021,Judith Basin,MT,"Judith Basin, MT",48352,-7,3024,129600,-81248,0.37
 2019,Juneau,WI,"Juneau, WI",40189,0,979,41957,-1768,0.96
 2020,Juneau,WI,"Juneau, WI",42982,7,1213,51986,-9004,0.83
 2021,Juneau,WI,"Juneau, WI",46040,7,1099,47100,-1060,0.98
 2019,Juniata,PA,"Juniata, PA",47788,0,592,25371,22417,1.88
 2020,Juniata,PA,"Juniata, PA",52855,11,683,29271,23584,1.81
 2021,Juniata,PA,"Juniata, PA",56422,7,945,40500,15922,1.39
 2019,Kalamazoo,MI,"Kalamazoo, MI",50835,0,1136,48686,2149,1.04
 2020,Kalamazoo,MI,"Kalamazoo, MI",54954,8,1214,52029,2925,1.06
 2021,Kalamazoo,MI,"Kalamazoo, MI",58524,7,1293,55414,3110,1.06
 2019,Kalkaska,MI,"Kalkaska, MI",36560,0,720,30857,5703,1.18
 2020,Kalkaska,MI,"Kalkaska, MI",41541,14,951,40757,784,1.02
 2021,Kalkaska,MI,"Kalkaska, MI",43609,5,1172,50229,-6620,0.87
 2019,Kanabec,MN,"Kanabec, MN",44473,0,992,42514,1959,1.05
 2020,Kanabec,MN,"Kanabec, MN",49721,12,1018,43629,6092,1.14
 2021,Kanabec,MN,"Kanabec, MN",51935,5,1471,63043,-11108,0.82
 2019,Kanawha,WV,"Kanawha, WV",49159,0,718,30771,18388,1.6
 2020,Kanawha,WV,"Kanawha, WV",52256,6,728,31200,21056,1.67
 2021,Kanawha,WV,"Kanawha, WV",55897,7,698,29914,25983,1.87
 2019,Kane,IL,"Kane, IL",54489,0,1548,66343,-11854,0.82
 2020,Kane,IL,"Kane, IL",58186,7,1514,64886,-6700,0.9
 2021,Kane,IL,"Kane, IL",62837,8,1630,69857,-7020,0.9
 2019,Kane,UT,"Kane, UT",42444,0,1454,62314,-19870,0.68
 2020,Kane,UT,"Kane, UT",46840,10,1628,69771,-22931,0.67
 2021,Kane,UT,"Kane, UT",49842,6,2783,119271,-69429,0.42
 2019,Kankakee,IL,"Kankakee, IL",43515,0,609,26100,17415,1.67
 2020,Kankakee,IL,"Kankakee, IL",47846,10,774,33171,14675,1.44
 2021,Kankakee,IL,"Kankakee, IL",53165,11,869,37243,15922,1.43
 2019,Karnes,TX,"Karnes, TX",65460,0,708,30343,35117,2.16
 2020,Karnes,TX,"Karnes, TX",63098,-4,676,28971,34127,2.18
 2021,Karnes,TX,"Karnes, TX",73144,16,707,30300,42844,2.41
 2019,Kauai,HI,"Kauai, HI",50670,0,4330,185571,-134901,0.27
 2020,Kauai,HI,"Kauai, HI",53608,6,5153,220843,-167235,0.24
 2021,Kauai,HI,"Kauai, HI",56103,5,4481,192043,-135940,0.29
 2019,Kaufman,TX,"Kaufman, TX",44362,0,1291,55329,-10967,0.8
 2020,Kaufman,TX,"Kaufman, TX",46288,4,1252,53657,-7369,0.86
 2021,Kaufman,TX,"Kaufman, TX",49494,7,1720,73714,-24220,0.67
 2019,Kay,OK,"Kay, OK",41547,0,516,22114,19433,1.88
 2020,Kay,OK,"Kay, OK",44804,8,513,21986,22818,2.04
 2021,Kay,OK,"Kay, OK",47817,7,461,19757,28060,2.42
 2019,Kearney,NE,"Kearney, NE",57267,0,741,31757,25510,1.8
 2020,Kearney,NE,"Kearney, NE",63956,12,522,22371,41585,2.86
 2021,Kearney,NE,"Kearney, NE",72421,13,962,41229,31192,1.76
 2019,Kearny,KS,"Kearny, KS",50533,0,707,30300,20233,1.67
 2020,Kearny,KS,"Kearny, KS",60667,20,630,27000,33667,2.25
 2021,Kearny,KS,"Kearny, KS",65779,8,665,28500,37279,2.31
 2019,Keith,NE,"Keith, NE",45436,0,823,35271,10165,1.29
 2020,Keith,NE,"Keith, NE",48869,8,849,36386,12483,1.34
 2021,Keith,NE,"Keith, NE",52394,7,1245,53357,-963,0.98
 2019,Kemper,MS,"Kemper, MS",32026,0,574,24600,7426,1.3
 2020,Kemper,MS,"Kemper, MS",36166,13,398,17057,19109,2.12
 2021,Kemper,MS,"Kemper, MS",38314,6,648,27771,10543,1.38
 2019,Kenai Peninsula,AK,"Kenai Peninsula, AK",54727,0,1218,52200,2527,1.05
 2020,Kenai Peninsula,AK,"Kenai Peninsula, AK",56224,3,1241,53186,3038,1.06
 2021,Kenai Peninsula,AK,"Kenai Peninsula, AK",59041,5,1576,67543,-8502,0.87
 2019,Kendall,IL,"Kendall, IL",51048,0,1343,57557,-6509,0.89
 2020,Kendall,IL,"Kendall, IL",53941,6,1366,58543,-4602,0.92
 2021,Kendall,IL,"Kendall, IL",58848,9,1626,69686,-10838,0.84
 2019,Kendall,TX,"Kendall, TX",92914,0,2269,97243,-4329,0.96
 2020,Kendall,TX,"Kendall, TX",93875,1,2505,107357,-13482,0.87
 2021,Kendall,TX,"Kendall, TX",96628,3,3108,133200,-36572,0.73
 2019,Kenedy,TX,"Kenedy, TX",43786,0,500,21429,22357,2.04
 2020,Kenedy,TX,"Kenedy, TX",45009,3,2154,92314,-47305,0.49
 2019,Kennebec,ME,"Kennebec, ME",46421,0,1006,43114,3307,1.08
 2020,Kennebec,ME,"Kennebec, ME",50530,9,1072,45943,4587,1.1
 2021,Kennebec,ME,"Kennebec, ME",53658,6,1372,58800,-5142,0.91
 2019,Kenosha,WI,"Kenosha, WI",49153,0,1189,50957,-1804,0.96
 2020,Kenosha,WI,"Kenosha, WI",52452,7,1195,51214,1238,1.02
 2021,Kenosha,WI,"Kenosha, WI",57085,9,1209,51814,5271,1.1
 2019,Kent,DE,"Kent, DE",44490,0,1266,54257,-9767,0.82
 2020,Kent,DE,"Kent, DE",46542,5,1321,56614,-10072,0.82
 2021,Kent,DE,"Kent, DE",50432,8,1742,74657,-24225,0.68
 2019,Kent,MD,"Kent, MD",59791,0,1437,61586,-1795,0.97
 2020,Kent,MD,"Kent, MD",63494,6,1477,63300,194,1
 2021,Kent,MD,"Kent, MD",67648,7,1627,69729,-2081,0.97
 2019,Kent,MI,"Kent, MI",54507,0,1398,59914,-5407,0.91
 2020,Kent,MI,"Kent, MI",58706,8,1467,62871,-4165,0.93
 2021,Kent,MI,"Kent, MI",61852,5,1410,60429,1423,1.02
 2019,Kent,RI,"Kent, RI",60103,0,1503,64414,-4311,0.93
 2020,Kent,RI,"Kent, RI",63582,6,1528,65486,-1904,0.97
 2021,Kent,RI,"Kent, RI",67906,7,1614,69171,-1265,0.98
 2019,Kent,TX,"Kent, TX",51451,0,785,33643,17808,1.53
 2020,Kent,TX,"Kent, TX",50963,-1,1403,60129,-9166,0.85
 2021,Kent,TX,"Kent, TX",55725,9,1331,57043,-1318,0.98
 2019,Kenton,KY,"Kenton, KY",58804,0,1008,43200,15604,1.36
 2020,Kenton,KY,"Kenton, KY",63533,8,1248,53486,10047,1.19
 2021,Kenton,KY,"Kenton, KY",67808,7,1475,63214,4594,1.07
 2019,Keokuk,IA,"Keokuk, IA",45012,0,343,14700,30312,3.06
 2020,Keokuk,IA,"Keokuk, IA",48468,8,449,19243,29225,2.52
 2021,Keokuk,IA,"Keokuk, IA",52878,9,478,20486,32392,2.58
 2019,Kern,CA,"Kern, CA",39477,0,1187,50871,-11394,0.78
 2020,Kern,CA,"Kern, CA",44063,12,1262,54086,-10023,0.81
 2021,Kern,CA,"Kern, CA",45961,4,1610,69000,-23039,0.67
 2019,Kerr,TX,"Kerr, TX",54721,0,1969,84386,-29665,0.65
 2020,Kerr,TX,"Kerr, TX",57402,5,2116,90686,-33284,0.63
 2021,Kerr,TX,"Kerr, TX",61401,7,2406,103114,-41713,0.6
 2019,Kershaw,SC,"Kershaw, SC",44272,0,993,42557,1715,1.04
 2020,Kershaw,SC,"Kershaw, SC",46901,6,1154,49457,-2556,0.95
 2021,Kershaw,SC,"Kershaw, SC",50635,8,1435,61500,-10865,0.82
 2019,Ketchikan Gateway,AK,"Ketchikan Gateway, AK",69052,0,1328,56914,12138,1.21
 2020,Ketchikan Gateway,AK,"Ketchikan Gateway, AK",67465,-2,1295,55500,11965,1.22
 2021,Ketchikan Gateway,AK,"Ketchikan Gateway, AK",72278,7,1690,72429,-151,1
 2019,Kewaunee,WI,"Kewaunee, WI",48091,0,886,37971,10120,1.27
 2020,Kewaunee,WI,"Kewaunee, WI",52271,9,1079,46243,6028,1.13
 2021,Kewaunee,WI,"Kewaunee, WI",54422,4,1565,67071,-12649,0.81
 2019,Keweenaw,MI,"Keweenaw, MI",50936,0,1549,66386,-15450,0.77
 2020,Keweenaw,MI,"Keweenaw, MI",56579,11,1038,44486,12093,1.27
 2021,Keweenaw,MI,"Keweenaw, MI",59593,5,2619,112243,-52650,0.53
 2019,Keya Paha,NE,"Keya Paha, NE",52357,0,408,17486,34871,2.99
 2020,Keya Paha,NE,"Keya Paha, NE",63851,22,342,14657,49194,4.36
 2021,Keya Paha,NE,"Keya Paha, NE",62968,-1,326,13971,48997,4.51
 2019,Kidder,ND,"Kidder, ND",53808,0,924,39600,14208,1.36
 2020,Kidder,ND,"Kidder, ND",66782,24,895,38357,28425,1.74
 2021,Kidder,ND,"Kidder, ND",74589,12,601,25757,48832,2.9
 2019,Kimball,NE,"Kimball, NE",46172,0,363,15557,30615,2.97
 2020,Kimball,NE,"Kimball, NE",52000,13,436,18686,33314,2.78
 2021,Kimball,NE,"Kimball, NE",55021,6,408,17486,37535,3.15
 2019,Kimble,TX,"Kimble, TX",48015,0,1782,76371,-28356,0.63
 2020,Kimble,TX,"Kimble, TX",50931,6,1314,56314,-5383,0.9
 2021,Kimble,TX,"Kimble, TX",54345,7,4336,185829,-131484,0.29
 2019,King George,VA,"King George, VA",56280,0,1688,72343,-16063,0.78
 2020,King George,VA,"King George, VA",59255,5,1774,76029,-16774,0.78
 2021,King George,VA,"King George, VA",62077,5,2128,91200,-29123,0.68
 2019,King William,VA,"King William, VA",47526,0,1136,48686,-1160,0.98
 2020,King William,VA,"King William, VA",50309,6,1200,51429,-1120,0.98
 2021,King William,VA,"King William, VA",53900,7,1580,67714,-13814,0.8
 2019,King,WA,"King, WA",95083,0,3449,147814,-52731,0.64
 2020,King,WA,"King, WA",99734,5,3463,148414,-48680,0.67
 2021,King,WA,"King, WA",108212,9,3401,145757,-37545,0.74
 2019,Kingfisher,OK,"Kingfisher, OK",59692,0,850,36429,23263,1.64
 2020,Kingfisher,OK,"Kingfisher, OK",61709,3,968,41486,20223,1.49
 2021,Kingfisher,OK,"Kingfisher, OK",67299,9,923,39557,27742,1.7
 2019,Kingman,KS,"Kingman, KS",43106,0,370,15857,27249,2.72
 2020,Kingman,KS,"Kingman, KS",48832,13,430,18429,30403,2.65
 2021,Kingman,KS,"Kingman, KS",52283,7,687,29443,22840,1.78
 2019,Kings,CA,"Kings, CA",36599,0,1251,53614,-17015,0.68
 2020,Kings,CA,"Kings, CA",41397,13,1218,52200,-10803,0.79
 2021,Kings,CA,"Kings, CA",43176,4,1468,62914,-19738,0.69
 2019,Kings,NY,"Kings, NY",51632,0,4137,177300,-125668,0.29
 2020,Kings,NY,"Kings, NY",56349,9,3831,164186,-107837,0.34
 2021,Kings,NY,"Kings, NY",61851,10,3550,152143,-90292,0.41
 2019,Kingsbury,SD,"Kingsbury, SD",55601,0,543,23271,32330,2.39
 2020,Kingsbury,SD,"Kingsbury, SD",66824,20,916,39257,27567,1.7
 2021,Kingsbury,SD,"Kingsbury, SD",70430,5,911,39043,31387,1.8
 2019,Kinney,TX,"Kinney, TX",36759,0,375,16071,20688,2.29
 2020,Kinney,TX,"Kinney, TX",40219,9,444,19029,21190,2.11
 2021,Kinney,TX,"Kinney, TX",42929,7,506,21686,21243,1.98
 2019,Kiowa,CO,"Kiowa, CO",52817,0,216,9257,43560,5.71
 2020,Kiowa,CO,"Kiowa, CO",53903,2,576,24686,29217,2.18
 2021,Kiowa,CO,"Kiowa, CO",75006,39,378,16200,58806,4.63
 2019,Kiowa,KS,"Kiowa, KS",41216,0,152,6514,34702,6.33
 2020,Kiowa,KS,"Kiowa, KS",51912,26,612,26229,25683,1.98
 2021,Kiowa,KS,"Kiowa, KS",57085,10,1061,45471,11614,1.26
 2019,Kiowa,OK,"Kiowa, OK",38343,0,378,16200,22143,2.37
 2020,Kiowa,OK,"Kiowa, OK",42364,11,427,18300,24064,2.31
 2021,Kiowa,OK,"Kiowa, OK",45875,8,580,24857,21018,1.85
 2019,Kit Carson,CO,"Kit Carson, CO",42172,0,1375,58929,-16757,0.72
 2020,Kit Carson,CO,"Kit Carson, CO",42436,1,925,39643,2793,1.07
 2021,Kit Carson,CO,"Kit Carson, CO",52253,23,1184,50743,1510,1.03
 2019,Kitsap,WA,"Kitsap, WA",58290,0,2124,91029,-32739,0.64
 2020,Kitsap,WA,"Kitsap, WA",62308,7,2217,95014,-32706,0.66
 2021,Kitsap,WA,"Kitsap, WA",67845,9,2872,123086,-55241,0.55
 2019,Kittitas,WA,"Kittitas, WA",47000,0,2024,86743,-39743,0.54
 2020,Kittitas,WA,"Kittitas, WA",50624,8,1947,83443,-32819,0.61
 2021,Kittitas,WA,"Kittitas, WA",52846,4,3098,132771,-79925,0.4
 2019,Kittson,MN,"Kittson, MN",46733,0,408,17486,29247,2.67
 2020,Kittson,MN,"Kittson, MN",63269,35,528,22629,40640,2.8
 2021,Kittson,MN,"Kittson, MN",67536,7,348,14914,52622,4.53
 2019,Klamath,OR,"Klamath, OR",40236,0,1194,51171,-10935,0.79
 2020,Klamath,OR,"Klamath, OR",44133,10,1216,52114,-7981,0.85
 2021,Klamath,OR,"Klamath, OR",48050,9,1677,71871,-23821,0.67
 2019,Kleberg,TX,"Kleberg, TX",40550,0,677,29014,11536,1.4
 2020,Kleberg,TX,"Kleberg, TX",42083,4,804,34457,7626,1.22
 2021,Kleberg,TX,"Kleberg, TX",45818,9,805,34500,11318,1.33
 2019,Klickitat,WA,"Klickitat, WA",49847,0,2117,90729,-40882,0.55
 2020,Klickitat,WA,"Klickitat, WA",53026,6,2321,99471,-46445,0.53
 2021,Klickitat,WA,"Klickitat, WA",55602,5,2095,89786,-34184,0.62
 2019,Knott,KY,"Knott, KY",32172,0,428,18343,13829,1.75
 2020,Knott,KY,"Knott, KY",36448,13,399,17100,19348,2.13
 2021,Knott,KY,"Knott, KY",41185,13,641,27471,13714,1.5
 2019,Knox,IL,"Knox, IL",39116,0,506,21686,17430,1.8
 2020,Knox,IL,"Knox, IL",43913,12,416,17829,26084,2.46
 2021,Knox,IL,"Knox, IL",47985,9,488,20914,27071,2.29
 2019,Knox,IN,"Knox, IN",45022,0,403,17271,27751,2.61
 2020,Knox,IN,"Knox, IN",49308,10,536,22971,26337,2.15
 2021,Knox,IN,"Knox, IN",53525,9,506,21686,31839,2.47
 2019,Knox,KY,"Knox, KY",30709,0,730,31286,-577,0.98
 2020,Knox,KY,"Knox, KY",35312,15,799,34243,1069,1.03
 2021,Knox,KY,"Knox, KY",39901,13,829,35529,4372,1.12
 2019,Knox,ME,"Knox, ME",53097,0,1422,60943,-7846,0.87
 2020,Knox,ME,"Knox, ME",56532,7,1613,69129,-12597,0.82
 2021,Knox,ME,"Knox, ME",59420,5,2079,89100,-29680,0.67
 2019,Knox,MO,"Knox, MO",37209,0,531,22757,14452,1.64
 2020,Knox,MO,"Knox, MO",41419,11,677,29014,12405,1.43
 2021,Knox,MO,"Knox, MO",42987,4,542,23229,19758,1.85
 2019,Knox,NE,"Knox, NE",46881,0,740,31714,15167,1.48
 2020,Knox,NE,"Knox, NE",53730,15,864,37029,16701,1.45
 2021,Knox,NE,"Knox, NE",57577,7,691,29614,27963,1.94
 2019,Knox,OH,"Knox, OH",45128,0,797,34157,10971,1.32
 2020,Knox,OH,"Knox, OH",48648,8,836,35829,12819,1.36
 2021,Knox,OH,"Knox, OH",52034,7,1119,47957,4077,1.09
 2019,Knox,TN,"Knox, TN",52753,0,1358,58200,-5447,0.91
 2020,Knox,TN,"Knox, TN",56206,7,1441,61757,-5551,0.91
 2021,Knox,TN,"Knox, TN",59934,7,1554,66600,-6666,0.9
 2019,Knox,TX,"Knox, TX",42658,0,200,8571,34087,4.98
 2020,Knox,TX,"Knox, TX",46817,10,231,9900,36917,4.73
 2021,Knox,TX,"Knox, TX",50320,8,436,18686,31634,2.69
 2019,Koochiching,MN,"Koochiching, MN",46188,0,820,35143,11045,1.31
 2020,Koochiching,MN,"Koochiching, MN",49257,7,811,34757,14500,1.42
 2021,Koochiching,MN,"Koochiching, MN",52256,6,907,38871,13385,1.34
 2019,Kootenai,ID,"Kootenai, ID",47745,0,1934,82886,-35141,0.58
 2020,Kootenai,ID,"Kootenai, ID",51109,7,2169,92957,-41848,0.55
 2021,Kootenai,ID,"Kootenai, ID",54406,7,3659,156814,-102408,0.35
 2019,Kosciusko,IN,"Kosciusko, IN",48562,0,1081,46329,2233,1.05
 2020,Kosciusko,IN,"Kosciusko, IN",51892,7,1261,54043,-2151,0.96
 2021,Kosciusko,IN,"Kosciusko, IN",55625,7,1323,56700,-1075,0.98
 2019,Kossuth,IA,"Kossuth, IA",50626,0,625,26786,23840,1.89
 2020,Kossuth,IA,"Kossuth, IA",52736,4,572,24514,28222,2.15
 2021,Kossuth,IA,"Kossuth, IA",60595,15,766,32829,27766,1.85
 2019,La Crosse,WI,"La Crosse, WI",51477,0,1282,54943,-3466,0.94
 2020,La Crosse,WI,"La Crosse, WI",54603,6,1243,53271,1332,1.03
 2021,La Crosse,WI,"La Crosse, WI",58301,7,1430,61286,-2985,0.95
 2019,La Paz,AZ,"La Paz, AZ",43174,0,863,36986,6188,1.17
 2020,La Paz,AZ,"La Paz, AZ",46286,7,888,38057,8229,1.22
 2021,La Paz,AZ,"La Paz, AZ",49933,8,1457,62443,-12510,0.8
 2019,La Plata,CO,"La Plata, CO",60274,0,2497,107014,-46740,0.56
 2020,La Plata,CO,"La Plata, CO",63179,5,2599,111386,-48207,0.57
 2021,La Plata,CO,"La Plata, CO",66944,6,4502,192943,-125999,0.35
 2019,La Salle,TX,"La Salle, TX",46332,0,813,34843,11489,1.33
 2020,La Salle,TX,"La Salle, TX",45909,-1,1508,64629,-18720,0.71
 2021,La Salle,TX,"La Salle, TX",52652,15,934,40029,12623,1.32
 2019,Labette,KS,"Labette, KS",42606,0,287,12300,30306,3.46
 2020,Labette,KS,"Labette, KS",46796,10,368,15771,31025,2.97
 2021,Labette,KS,"Labette, KS",49538,6,295,12643,36895,3.92
 2019,Lac Qui Parle,MN,"Lac Qui Parle, MN",49909,0,499,21386,28523,2.33
 2020,Lac Qui Parle,MN,"Lac Qui Parle, MN",58221,17,678,29057,29164,2
 2021,Lac Qui Parle,MN,"Lac Qui Parle, MN",65109,12,671,28757,36352,2.26
 2019,Lackawanna,PA,"Lackawanna, PA",47435,0,715,30643,16792,1.55
 2020,Lackawanna,PA,"Lackawanna, PA",51419,8,756,32400,19019,1.59
 2021,Lackawanna,PA,"Lackawanna, PA",54380,6,857,36729,17651,1.48
 2019,Laclede,MO,"Laclede, MO",36383,0,853,36557,-174,1
 2020,Laclede,MO,"Laclede, MO",39088,7,927,39729,-641,0.98
 2021,Laclede,MO,"Laclede, MO",41266,6,931,39900,1366,1.03
 2019,Lafayette,AR,"Lafayette, AR",37184,0,397,17014,20170,2.19
 2020,Lafayette,AR,"Lafayette, AR",40154,8,500,21429,18725,1.87
 2021,Lafayette,AR,"Lafayette, AR",47355,18,794,34029,13326,1.39
 2019,Lafayette,FL,"Lafayette, FL",27405,0,930,39857,-12452,0.69
 2020,Lafayette,FL,"Lafayette, FL",29032,6,1106,47400,-18368,0.61
 2021,Lafayette,FL,"Lafayette, FL",31218,8,1439,61671,-30453,0.51
 2019,Lafayette,LA,"Lafayette, LA",50776,0,1107,47443,3333,1.07
 2020,Lafayette,LA,"Lafayette, LA",54881,8,1111,47614,7267,1.15
 2021,Lafayette,LA,"Lafayette, LA",57674,5,1461,62614,-4940,0.92
 2019,Lafayette,MO,"Lafayette, MO",42782,0,655,28071,14711,1.52
 2020,Lafayette,MO,"Lafayette, MO",46053,8,679,29100,16953,1.58
 2021,Lafayette,MO,"Lafayette, MO",49491,8,881,37757,11734,1.31
 2019,Lafayette,MS,"Lafayette, MS",43373,0,1226,52543,-9170,0.83
 2020,Lafayette,MS,"Lafayette, MS",45615,5,1255,53786,-8171,0.85
 2021,Lafayette,MS,"Lafayette, MS",47824,5,1930,82714,-34890,0.58
 2019,Lafayette,WI,"Lafayette, WI",43860,0,794,34029,9831,1.29
 2020,Lafayette,WI,"Lafayette, WI",48962,12,748,32057,16905,1.53
 2021,Lafayette,WI,"Lafayette, WI",52194,7,896,38400,13794,1.36
 2019,Lafourche,LA,"Lafourche, LA",45735,0,931,39900,5835,1.15
 2020,Lafourche,LA,"Lafourche, LA",47063,3,921,39471,7592,1.19
 2021,Lafourche,LA,"Lafourche, LA",49614,5,921,39471,10143,1.26
 2019,Lagrange,IN,"Lagrange, IN",41365,0,747,32014,9351,1.29
 2020,Lagrange,IN,"Lagrange, IN",44238,7,948,40629,3609,1.09
 2021,Lagrange,IN,"Lagrange, IN",49767,13,1235,52929,-3162,0.94
 2019,Lake Of The Woods,MN,"Lake Of The Woods, MN",54841,0,1062,45514,9327,1.2
 2020,Lake Of The Woods,MN,"Lake Of The Woods, MN",56693,3,966,41400,15293,1.37
 2021,Lake Of The Woods,MN,"Lake Of The Woods, MN",61309,8,1581,67757,-6448,0.9
 2019,Lake,CA,"Lake, CA",40457,0,1531,65614,-25157,0.62
 2020,Lake,CA,"Lake, CA",44403,10,1368,58629,-14226,0.76
 2021,Lake,CA,"Lake, CA",46918,6,1853,79414,-32496,0.59
 2019,Lake,CO,"Lake, CO",40328,0,1708,73200,-32872,0.55
 2020,Lake,CO,"Lake, CO",44537,10,1584,67886,-23349,0.66
 2021,Lake,CO,"Lake, CO",48942,10,2758,118200,-69258,0.41
 2019,Lake,FL,"Lake, FL",43878,0,1328,56914,-13036,0.77
 2020,Lake,FL,"Lake, FL",45880,5,1362,58371,-12491,0.79
 2021,Lake,FL,"Lake, FL",49831,9,1819,77957,-28126,0.64
 2019,Lake,IL,"Lake, IL",79993,0,1875,80357,-364,1
 2020,Lake,IL,"Lake, IL",83141,4,1877,80443,2698,1.03
 2021,Lake,IL,"Lake, IL",89025,7,1694,72600,16425,1.23
 2019,Lake,IN,"Lake, IN",45470,0,947,40586,4884,1.12
 2020,Lake,IN,"Lake, IN",48523,7,973,41700,6823,1.16
 2021,Lake,IN,"Lake, IN",53181,10,1203,51557,1624,1.03
 2019,Lake,MI,"Lake, MI",33362,0,450,19286,14076,1.73
 2020,Lake,MI,"Lake, MI",37938,14,624,26743,11195,1.42
 2021,Lake,MI,"Lake, MI",38989,3,766,32829,6160,1.19
 2019,Lake,MN,"Lake, MN",47886,0,908,38914,8972,1.23
 2020,Lake,MN,"Lake, MN",50311,5,847,36300,14011,1.39
 2021,Lake,MN,"Lake, MN",53868,7,932,39943,13925,1.35
 2019,Lake,MT,"Lake, MT",40510,0,2562,109800,-69290,0.37
 2020,Lake,MT,"Lake, MT",44565,10,2456,105257,-60692,0.42
 2021,Lake,MT,"Lake, MT",46387,4,3912,167657,-121270,0.28
 2019,Lake,OH,"Lake, OH",52503,0,877,37586,14917,1.4
 2020,Lake,OH,"Lake, OH",55688,6,950,40714,14974,1.37
 2021,Lake,OH,"Lake, OH",58960,6,1019,43671,15289,1.35
 2019,Lake,OR,"Lake, OR",40872,0,688,29486,11386,1.39
 2020,Lake,OR,"Lake, OR",44274,8,1046,44829,-555,0.99
 2021,Lake,OR,"Lake, OR",47066,6,1065,45643,1423,1.03
 2019,Lake,SD,"Lake, SD",57067,0,1273,54557,2510,1.05
 2020,Lake,SD,"Lake, SD",64650,13,1048,44914,19736,1.44
 2021,Lake,SD,"Lake, SD",69817,8,1132,48514,21303,1.44
 2019,Lake,TN,"Lake, TN",24802,0,448,19200,5602,1.29
 2020,Lake,TN,"Lake, TN",26127,5,420,18000,8127,1.45
 2021,Lake,TN,"Lake, TN",29534,13,556,23829,5705,1.24
 2019,Lamar,AL,"Lamar, AL",34162,0,422,18086,16076,1.89
 2020,Lamar,AL,"Lamar, AL",36737,8,377,16157,20580,2.27
 2021,Lamar,AL,"Lamar, AL",40114,9,684,29314,10800,1.37
 2019,Lamar,GA,"Lamar, GA",35752,0,727,31157,4595,1.15
 2020,Lamar,GA,"Lamar, GA",38669,8,1005,43071,-4402,0.9
 2021,Lamar,GA,"Lamar, GA",41856,8,1231,52757,-10901,0.79
 2019,Lamar,MS,"Lamar, MS",41585,0,1173,50271,-8686,0.83
 2020,Lamar,MS,"Lamar, MS",44325,7,1175,50357,-6032,0.88
 2021,Lamar,MS,"Lamar, MS",47129,6,1303,55843,-8714,0.84
 2019,Lamar,TX,"Lamar, TX",43454,0,790,33857,9597,1.28
 2020,Lamar,TX,"Lamar, TX",46767,8,850,36429,10338,1.28
 2021,Lamar,TX,"Lamar, TX",50699,8,1195,51214,-515,0.99
 2019,Lamb,TX,"Lamb, TX",45345,0,595,25500,19845,1.78
 2020,Lamb,TX,"Lamb, TX",49815,10,637,27300,22515,1.82
 2021,Lamb,TX,"Lamb, TX",54689,10,803,34414,20275,1.59
 2019,Lamoille,VT,"Lamoille, VT",55262,0,1481,63471,-8209,0.87
 2020,Lamoille,VT,"Lamoille, VT",59543,8,1496,64114,-4571,0.93
 2021,Lamoille,VT,"Lamoille, VT",62305,5,1521,65186,-2881,0.96
 2019,Lamoure,ND,"Lamoure, ND",60029,0,200,8571,51458,7
 2020,Lamoure,ND,"Lamoure, ND",70840,18,469,20100,50740,3.52
 2021,Lamoure,ND,"Lamoure, ND",72712,3,366,15686,57026,4.64
 2019,Lampasas,TX,"Lampasas, TX",52701,0,1078,46200,6501,1.14
 2020,Lampasas,TX,"Lampasas, TX",55465,5,1160,49714,5751,1.12
 2021,Lampasas,TX,"Lampasas, TX",58507,6,1818,77914,-19407,0.75
 2019,Lancaster,NE,"Lancaster, NE",51035,0,1363,58414,-7379,0.87
 2020,Lancaster,NE,"Lancaster, NE",53827,6,1459,62529,-8702,0.86
 2021,Lancaster,NE,"Lancaster, NE",56782,6,1596,68400,-11618,0.83
 2019,Lancaster,PA,"Lancaster, PA",54061,0,1343,57557,-3496,0.94
 2020,Lancaster,PA,"Lancaster, PA",58214,8,1512,64800,-6586,0.9
 2021,Lancaster,PA,"Lancaster, PA",61547,6,1607,68871,-7324,0.89
 2019,Lancaster,SC,"Lancaster, SC",53991,0,1561,66900,-12909,0.81
 2020,Lancaster,SC,"Lancaster, SC",51986,-4,1645,70500,-18514,0.74
 2021,Lancaster,SC,"Lancaster, SC",55033,6,1648,70629,-15596,0.78
 2019,Lancaster,VA,"Lancaster, VA",62479,0,2128,91200,-28721,0.69
 2020,Lancaster,VA,"Lancaster, VA",66366,6,1733,74271,-7905,0.89
 2021,Lancaster,VA,"Lancaster, VA",70474,6,1650,70714,-240,1
 2019,Lane,KS,"Lane, KS",63880,0,459,19671,44209,3.25
 2020,Lane,KS,"Lane, KS",69724,9,486,20829,48895,3.35
 2021,Lane,KS,"Lane, KS",75517,8,419,17957,57560,4.21
 2019,Lane,OR,"Lane, OR",46752,0,1815,77786,-31034,0.6
 2020,Lane,OR,"Lane, OR",51272,10,1922,82371,-31099,0.62
 2021,Lane,OR,"Lane, OR",55146,8,2214,94886,-39740,0.58
 2019,Langlade,WI,"Langlade, WI",44264,0,704,30171,14093,1.47
 2020,Langlade,WI,"Langlade, WI",48118,9,754,32314,15804,1.49
 2021,Langlade,WI,"Langlade, WI",51008,6,732,31371,19637,1.63
 2019,Lanier,GA,"Lanier, GA",30792,0,661,28329,2463,1.09
 2020,Lanier,GA,"Lanier, GA",33643,9,723,30986,2657,1.09
 2021,Lanier,GA,"Lanier, GA",36086,7,464,19886,16200,1.81
 2019,Lapeer,MI,"Lapeer, MI",44648,0,1165,49929,-5281,0.89
 2020,Lapeer,MI,"Lapeer, MI",49285,10,1247,53443,-4158,0.92
 2021,Lapeer,MI,"Lapeer, MI",52034,6,1678,71914,-19880,0.72
 2019,Laporte,IN,"Laporte, IN",42076,0,1027,44014,-1938,0.96
 2020,Laporte,IN,"Laporte, IN",45323,8,1183,50700,-5377,0.89
 2021,Laporte,IN,"Laporte, IN",49508,9,1023,43843,5665,1.13
 2019,Laramie,WY,"Laramie, WY",53181,0,1402,60086,-6905,0.89
 2020,Laramie,WY,"Laramie, WY",54959,3,1708,73200,-18241,0.75
 2021,Laramie,WY,"Laramie, WY",58646,7,1905,81643,-22997,0.72
 2019,Larimer,CO,"Larimer, CO",56851,0,2124,91029,-34178,0.62
 2020,Larimer,CO,"Larimer, CO",60219,6,2144,91886,-31667,0.66
 2021,Larimer,CO,"Larimer, CO",64258,7,2604,111600,-47342,0.58
 2019,Larue,KY,"Larue, KY",37766,0,629,26957,10809,1.4
 2020,Larue,KY,"Larue, KY",41291,9,713,30557,10734,1.35
 2021,Larue,KY,"Larue, KY",45069,9,1078,46200,-1131,0.98
 2019,Las Animas,CO,"Las Animas, CO",38055,0,1081,46329,-8274,0.82
 2020,Las Animas,CO,"Las Animas, CO",42016,10,1184,50743,-8727,0.83
 2021,Las Animas,CO,"Las Animas, CO",44731,7,1877,80443,-35712,0.56
 2019,Lasalle,IL,"Lasalle, IL",44823,0,592,25371,19452,1.77
 2020,Lasalle,IL,"Lasalle, IL",48460,8,624,26743,21717,1.81
 2021,Lasalle,IL,"Lasalle, IL",53033,9,708,30343,22690,1.75
 2019,Lasalle,LA,"Lasalle, LA",34187,0,700,30000,4187,1.14
 2020,Lasalle,LA,"Lasalle, LA",36200,6,847,36300,-100,1
 2021,Lasalle,LA,"Lasalle, LA",37546,4,1246,53400,-15854,0.7
 2019,Lassen,CA,"Lassen, CA",33092,0,1097,47014,-13922,0.7
 2020,Lassen,CA,"Lassen, CA",37634,14,1082,46371,-8737,0.81
 2021,Lassen,CA,"Lassen, CA",39394,5,1520,65143,-25749,0.6
 2019,Latah,ID,"Latah, ID",44601,0,1649,70671,-26070,0.63
 2020,Latah,ID,"Latah, ID",47859,7,1374,58886,-11027,0.81
 2021,Latah,ID,"Latah, ID",50703,6,2515,107786,-57083,0.47
 2019,Latimer,OK,"Latimer, OK",36760,0,397,17014,19746,2.16
 2020,Latimer,OK,"Latimer, OK",38117,4,579,24814,13303,1.54
 2021,Latimer,OK,"Latimer, OK",40932,7,1327,56871,-15939,0.72
 2019,Lauderdale,AL,"Lauderdale, AL",38681,0,870,37286,1395,1.04
 2020,Lauderdale,AL,"Lauderdale, AL",41778,8,885,37929,3849,1.1
 2021,Lauderdale,AL,"Lauderdale, AL",44804,7,1017,43586,1218,1.03
 2019,Lauderdale,MS,"Lauderdale, MS",40424,0,716,30686,9738,1.32
 2020,Lauderdale,MS,"Lauderdale, MS",44001,9,655,28071,15930,1.57
 2021,Lauderdale,MS,"Lauderdale, MS",46219,5,769,32957,13262,1.4
 2019,Lauderdale,TN,"Lauderdale, TN",32784,0,425,18214,14570,1.8
 2020,Lauderdale,TN,"Lauderdale, TN",36121,10,551,23614,12507,1.53
 2021,Lauderdale,TN,"Lauderdale, TN",39733,10,425,18214,21519,2.18
 2019,Laurel,KY,"Laurel, KY",33602,0,864,37029,-3427,0.91
 2020,Laurel,KY,"Laurel, KY",37362,11,874,37457,-95,1
 2021,Laurel,KY,"Laurel, KY",41037,10,1272,54514,-13477,0.75
 2019,Laurens,GA,"Laurens, GA",36805,0,610,26143,10662,1.41
 2020,Laurens,GA,"Laurens, GA",40198,9,626,26829,13369,1.5
 2021,Laurens,GA,"Laurens, GA",43532,8,1102,47229,-3697,0.92
 2019,Laurens,SC,"Laurens, SC",36102,0,824,35314,788,1.02
 2020,Laurens,SC,"Laurens, SC",38476,7,1037,44443,-5967,0.87
 2021,Laurens,SC,"Laurens, SC",41245,7,1331,57043,-15798,0.72
 2019,Lavaca,TX,"Lavaca, TX",56955,0,1164,49886,7069,1.14
 2020,Lavaca,TX,"Lavaca, TX",58629,3,1112,47657,10972,1.23
 2021,Lavaca,TX,"Lavaca, TX",62375,6,1409,60386,1989,1.03
 2019,Lawrence,AL,"Lawrence, AL",35643,0,742,31800,3843,1.12
 2020,Lawrence,AL,"Lawrence, AL",38225,7,757,32443,5782,1.18
 2021,Lawrence,AL,"Lawrence, AL",42996,13,1111,47614,-4618,0.9
 2019,Lawrence,AR,"Lawrence, AR",34286,0,454,19457,14829,1.76
 2020,Lawrence,AR,"Lawrence, AR",39170,14,472,20229,18941,1.94
 2021,Lawrence,AR,"Lawrence, AR",40161,3,627,26871,13290,1.49
 2019,Lawrence,IL,"Lawrence, IL",31181,0,364,15600,15581,2
 2020,Lawrence,IL,"Lawrence, IL",35950,15,577,24729,11221,1.45
 2021,Lawrence,IL,"Lawrence, IL",40385,12,537,23014,17371,1.75
 2019,Lawrence,IN,"Lawrence, IN",43253,0,639,27386,15867,1.58
 2020,Lawrence,IN,"Lawrence, IN",47040,9,777,33300,13740,1.41
 2021,Lawrence,IN,"Lawrence, IN",51160,9,1115,47786,3374,1.07
 2019,Lawrence,KY,"Lawrence, KY",31541,0,830,35571,-4030,0.89
 2020,Lawrence,KY,"Lawrence, KY",34590,10,667,28586,6004,1.21
 2021,Lawrence,KY,"Lawrence, KY",38139,10,930,39857,-1718,0.96
 2019,Lawrence,MO,"Lawrence, MO",35094,0,600,25714,9380,1.36
 2020,Lawrence,MO,"Lawrence, MO",37596,7,585,25071,12525,1.5
 2021,Lawrence,MO,"Lawrence, MO",39889,6,692,29657,10232,1.35
 2019,Lawrence,MS,"Lawrence, MS",36191,0,469,20100,16091,1.8
 2020,Lawrence,MS,"Lawrence, MS",37809,5,591,25329,12480,1.49
 2021,Lawrence,MS,"Lawrence, MS",42275,12,679,29100,13175,1.45
 2019,Lawrence,OH,"Lawrence, OH",40440,0,619,26529,13911,1.52
 2020,Lawrence,OH,"Lawrence, OH",43730,8,627,26871,16859,1.63
 2021,Lawrence,OH,"Lawrence, OH",46838,7,574,24600,22238,1.9
 2019,Lawrence,PA,"Lawrence, PA",44147,0,436,18686,25461,2.36
 2020,Lawrence,PA,"Lawrence, PA",48385,10,495,21214,27171,2.28
 2021,Lawrence,PA,"Lawrence, PA",51611,7,647,27729,23882,1.86
 2019,Lawrence,SD,"Lawrence, SD",54648,0,1696,72686,-18038,0.75
 2020,Lawrence,SD,"Lawrence, SD",57791,6,2042,87514,-29723,0.66
 2021,Lawrence,SD,"Lawrence, SD",60510,5,2320,99429,-38919,0.61
 2019,Lawrence,TN,"Lawrence, TN",35784,0,914,39171,-3387,0.91
 2020,Lawrence,TN,"Lawrence, TN",37678,5,1062,45514,-7836,0.83
 2021,Lawrence,TN,"Lawrence, TN",41310,10,1321,56614,-15304,0.73
 2019,Le Flore,OK,"Le Flore, OK",34678,0,601,25757,8921,1.35
 2020,Le Flore,OK,"Le Flore, OK",36472,5,655,28071,8401,1.3
 2021,Le Flore,OK,"Le Flore, OK",40214,10,877,37586,2628,1.07
 2019,Le Sueur,MN,"Le Sueur, MN",50203,0,1144,49029,1174,1.02
 2020,Le Sueur,MN,"Le Sueur, MN",54455,9,1293,55414,-959,0.98
 2021,Le Sueur,MN,"Le Sueur, MN",58146,7,1578,67629,-9483,0.86
 2019,Lea,NM,"Lea, NM",48054,0,915,39214,8840,1.23
 2020,Lea,NM,"Lea, NM",45169,-6,896,38400,6769,1.18
 2021,Lea,NM,"Lea, NM",48578,8,905,38786,9792,1.25
 2019,Leake,MS,"Leake, MS",34110,0,540,23143,10967,1.47
 2020,Leake,MS,"Leake, MS",34488,1,623,26700,7788,1.29
 2021,Leake,MS,"Leake, MS",39087,13,869,37243,1844,1.05
 2019,Leavenworth,KS,"Leavenworth, KS",44445,0,1317,56443,-11998,0.79
 2020,Leavenworth,KS,"Leavenworth, KS",46742,5,1437,61586,-14844,0.76
 2021,Leavenworth,KS,"Leavenworth, KS",49330,6,1679,71957,-22627,0.69
 2019,Lebanon,PA,"Lebanon, PA",48912,0,1089,46671,2241,1.05
 2020,Lebanon,PA,"Lebanon, PA",52399,7,1250,53571,-1172,0.98
 2021,Lebanon,PA,"Lebanon, PA",55803,7,1129,48386,7417,1.15
 2019,Lee,AL,"Lee, AL",39355,0,1380,59143,-19788,0.67
 2020,Lee,AL,"Lee, AL",41760,6,1360,58286,-16526,0.72
 2021,Lee,AL,"Lee, AL",45002,8,1680,72000,-26998,0.63
 2019,Lee,AR,"Lee, AR",30106,0,393,16843,13263,1.79
 2020,Lee,AR,"Lee, AR",34169,14,466,19971,14198,1.71
 2021,Lee,AR,"Lee, AR",37128,9,479,20529,16599,1.81
 2019,Lee,FL,"Lee, FL",56549,0,1426,61114,-4565,0.93
 2020,Lee,FL,"Lee, FL",59300,5,1510,64714,-5414,0.92
 2021,Lee,FL,"Lee, FL",62885,6,2065,88500,-25615,0.71
 2019,Lee,GA,"Lee, GA",43869,0,988,42343,1526,1.04
 2020,Lee,GA,"Lee, GA",47008,7,1069,45814,1194,1.03
 2021,Lee,GA,"Lee, GA",50409,7,1223,52414,-2005,0.96
 2019,Lee,IA,"Lee, IA",42384,0,554,23743,18641,1.79
 2020,Lee,IA,"Lee, IA",45316,7,485,20786,24530,2.18
 2021,Lee,IA,"Lee, IA",48394,7,533,22843,25551,2.12
 2019,Lee,IL,"Lee, IL",42295,0,589,25243,17052,1.68
 2020,Lee,IL,"Lee, IL",46704,10,631,27043,19661,1.73
 2021,Lee,IL,"Lee, IL",51124,10,670,28714,22410,1.78
 2019,Lee,KY,"Lee, KY",28856,0,579,24814,4042,1.16
 2020,Lee,KY,"Lee, KY",32876,14,554,23743,9133,1.38
 2021,Lee,KY,"Lee, KY",36847,12,645,27643,9204,1.33
 2019,Lee,MS,"Lee, MS",44363,0,966,41400,2963,1.07
 2020,Lee,MS,"Lee, MS",48080,8,1006,43114,4966,1.12
 2021,Lee,MS,"Lee, MS",51703,8,1218,52200,-497,0.99
 2019,Lee,NC,"Lee, NC",42355,0,1082,46371,-4016,0.91
 2020,Lee,NC,"Lee, NC",45022,6,1117,47871,-2849,0.94
 2021,Lee,NC,"Lee, NC",49136,9,1574,67457,-18321,0.73
 2019,Lee,SC,"Lee, SC",33989,0,715,30643,3346,1.11
 2020,Lee,SC,"Lee, SC",37142,9,650,27857,9285,1.33
 2021,Lee,SC,"Lee, SC",41364,11,660,28286,13078,1.46
 2019,Lee,TX,"Lee, TX",54789,0,1197,51300,3489,1.07
 2020,Lee,TX,"Lee, TX",54663,0,1157,49586,5077,1.1
 2021,Lee,TX,"Lee, TX",56674,4,1770,75857,-19183,0.75
 2019,Lee,VA,"Lee, VA",31270,0,429,18386,12884,1.7
 2020,Lee,VA,"Lee, VA",34950,12,447,19157,15793,1.82
 2021,Lee,VA,"Lee, VA",38300,10,616,26400,11900,1.45
 2019,Leelanau,MI,"Leelanau, MI",70525,0,2215,94929,-24404,0.74
 2020,Leelanau,MI,"Leelanau, MI",75114,7,2308,98914,-23800,0.76
 2021,Leelanau,MI,"Leelanau, MI",78457,5,3393,145414,-66957,0.54
 2019,Leflore,MS,"Leflore, MS",38631,0,514,22029,16602,1.75
 2020,Leflore,MS,"Leflore, MS",43521,13,609,26100,17421,1.67
 2021,Leflore,MS,"Leflore, MS",48265,11,482,20657,27608,2.34
 2019,Lehigh,PA,"Lehigh, PA",54791,0,1179,50529,4262,1.08
 2020,Lehigh,PA,"Lehigh, PA",58227,6,1197,51300,6927,1.14
 2021,Lehigh,PA,"Lehigh, PA",62537,7,1524,65314,-2777,0.96
 2019,Lemhi,ID,"Lemhi, ID",43898,0,1442,61800,-17902,0.71
 2020,Lemhi,ID,"Lemhi, ID",48508,11,1315,56357,-7849,0.86
 2021,Lemhi,ID,"Lemhi, ID",50927,5,2300,98571,-47644,0.52
 2019,Lenawee,MI,"Lenawee, MI",40377,0,791,33900,6477,1.19
 2020,Lenawee,MI,"Lenawee, MI",44112,9,783,33557,10555,1.31
 2021,Lenawee,MI,"Lenawee, MI",46929,6,1014,43457,3472,1.08
 2019,Lenoir,NC,"Lenoir, NC",41500,0,571,24471,17029,1.7
 2020,Lenoir,NC,"Lenoir, NC",45319,9,550,23571,21748,1.92
 2021,Lenoir,NC,"Lenoir, NC",50363,11,762,32657,17706,1.54
 2019,Leon,FL,"Leon, FL",46842,0,1135,48643,-1801,0.96
 2020,Leon,FL,"Leon, FL",49821,6,1112,47657,2164,1.05
 2021,Leon,FL,"Leon, FL",54277,9,1268,54343,-66,1
 2019,Leon,TX,"Leon, TX",45690,0,705,30214,15476,1.51
 2020,Leon,TX,"Leon, TX",48364,6,796,34114,14250,1.42
 2021,Leon,TX,"Leon, TX",53179,10,1112,47657,5522,1.12
 2019,Leslie,KY,"Leslie, KY",31744,0,354,15171,16573,2.09
 2020,Leslie,KY,"Leslie, KY",35932,13,360,15429,20503,2.33
 2021,Leslie,KY,"Leslie, KY",40852,14,562,24086,16766,1.7
 2019,Letcher,KY,"Letcher, KY",31543,0,478,20486,11057,1.54
 2020,Letcher,KY,"Letcher, KY",35818,14,425,18214,17604,1.97
 2021,Letcher,KY,"Letcher, KY",40315,13,451,19329,20986,2.09
 2019,Levy,FL,"Levy, FL",37460,0,1119,47957,-10497,0.78
 2020,Levy,FL,"Levy, FL",40271,8,1229,52671,-12400,0.76
 2021,Levy,FL,"Levy, FL",43272,8,1667,71443,-28171,0.61
 2019,Lewis,ID,"Lewis, ID",53580,0,696,29829,23751,1.8
 2020,Lewis,ID,"Lewis, ID",59260,11,783,33557,25703,1.77
 2021,Lewis,ID,"Lewis, ID",62533,6,1426,61114,1419,1.02
 2019,Lewis,KY,"Lewis, KY",32115,0,555,23786,8329,1.35
 2020,Lewis,KY,"Lewis, KY",36513,14,415,17786,18727,2.05
 2021,Lewis,KY,"Lewis, KY",40075,10,978,41914,-1839,0.96
 2019,Lewis,MO,"Lewis, MO",35602,0,414,17743,17859,2.01
 2020,Lewis,MO,"Lewis, MO",38514,8,846,36257,2257,1.06
 2021,Lewis,MO,"Lewis, MO",41823,9,391,16757,25066,2.5
 2019,Lewis,NY,"Lewis, NY",46957,0,620,26571,20386,1.77
 2020,Lewis,NY,"Lewis, NY",51181,9,693,29700,21481,1.72
 2021,Lewis,NY,"Lewis, NY",54629,7,801,34329,20300,1.59
 2019,Lewis,TN,"Lewis, TN",36069,0,1031,44186,-8117,0.82
 2020,Lewis,TN,"Lewis, TN",39399,9,1046,44829,-5430,0.88
 2021,Lewis,TN,"Lewis, TN",41476,5,1051,45043,-3567,0.92
 2019,Lewis,WA,"Lewis, WA",44310,0,1520,65143,-20833,0.68
 2020,Lewis,WA,"Lewis, WA",48320,9,1507,64586,-16266,0.75
 2021,Lewis,WA,"Lewis, WA",52517,9,2093,89700,-37183,0.59
 2019,Lewis,WV,"Lewis, WV",40035,0,715,30643,9392,1.31
 2020,Lewis,WV,"Lewis, WV",40991,2,707,30300,10691,1.35
 2021,Lewis,WV,"Lewis, WV",43341,6,643,27557,15784,1.57
 2019,Lexington,SC,"Lexington, SC",49874,0,1090,46714,3160,1.07
 2020,Lexington,SC,"Lexington, SC",51900,4,1106,47400,4500,1.09
 2021,Lexington,SC,"Lexington, SC",55304,7,1396,59829,-4525,0.92
 2019,Liberty,FL,"Liberty, FL",26830,0,1250,53571,-26741,0.5
 2020,Liberty,FL,"Liberty, FL",29988,12,733,31414,-1426,0.95
 2021,Liberty,FL,"Liberty, FL",32872,10,1070,45857,-12985,0.72
 2019,Liberty,GA,"Liberty, GA",35581,0,788,33771,1810,1.05
 2020,Liberty,GA,"Liberty, GA",38518,8,812,34800,3718,1.11
 2021,Liberty,GA,"Liberty, GA",41672,8,1155,49500,-7828,0.84
 2019,Liberty,MT,"Liberty, MT",55944,0,564,24171,31773,2.31
 2020,Liberty,MT,"Liberty, MT",60873,9,320,13714,47159,4.44
 2021,Liberty,MT,"Liberty, MT",57219,-6,1007,43157,14062,1.33
 2019,Liberty,TX,"Liberty, TX",38998,0,943,40414,-1416,0.96
 2020,Liberty,TX,"Liberty, TX",40839,5,950,40714,125,1
 2021,Liberty,TX,"Liberty, TX",42813,5,1241,53186,-10373,0.8
 2019,Licking,OH,"Licking, OH",47531,0,1092,46800,731,1.02
 2020,Licking,OH,"Licking, OH",51377,8,1249,53529,-2152,0.96
 2021,Licking,OH,"Licking, OH",54525,6,1397,59871,-5346,0.91
 2019,Limestone,AL,"Limestone, AL",44672,0,1206,51686,-7014,0.86
 2020,Limestone,AL,"Limestone, AL",47397,6,1299,55671,-8274,0.85
 2021,Limestone,AL,"Limestone, AL",50326,6,1727,74014,-23688,0.68
 2019,Limestone,TX,"Limestone, TX",40347,0,752,32229,8118,1.25
 2020,Limestone,TX,"Limestone, TX",42949,6,709,30386,12563,1.41
 2021,Limestone,TX,"Limestone, TX",47439,11,1060,45429,2010,1.04
 2019,Lincoln,AR,"Lincoln, AR",27391,0,617,26443,948,1.04
 2020,Lincoln,AR,"Lincoln, AR",29548,8,680,29143,405,1.01
 2021,Lincoln,AR,"Lincoln, AR",33387,13,639,27386,6001,1.22
 2019,Lincoln,CO,"Lincoln, CO",29608,0,903,38700,-9092,0.77
 2020,Lincoln,CO,"Lincoln, CO",32951,11,1147,49157,-16206,0.67
 2021,Lincoln,CO,"Lincoln, CO",37623,14,1079,46243,-8620,0.81
 2019,Lincoln,GA,"Lincoln, GA",40638,0,808,34629,6009,1.17
 2020,Lincoln,GA,"Lincoln, GA",43594,7,1332,57086,-13492,0.76
 2021,Lincoln,GA,"Lincoln, GA",46087,6,1979,84814,-38727,0.54
 2019,Lincoln,ID,"Lincoln, ID",40523,0,888,38057,2466,1.06
 2020,Lincoln,ID,"Lincoln, ID",42555,5,819,35100,7455,1.21
 2021,Lincoln,ID,"Lincoln, ID",42718,0,1391,59614,-16896,0.72
 2019,Lincoln,KS,"Lincoln, KS",46040,0,283,12129,33911,3.8
 2020,Lincoln,KS,"Lincoln, KS",54756,19,426,18257,36499,3
 2021,Lincoln,KS,"Lincoln, KS",56308,3,398,17057,39251,3.3
 2019,Lincoln,KY,"Lincoln, KY",33872,0,646,27686,6186,1.22
 2020,Lincoln,KY,"Lincoln, KY",37441,11,639,27386,10055,1.37
 2021,Lincoln,KY,"Lincoln, KY",40880,9,884,37886,2994,1.08
 2019,Lincoln,LA,"Lincoln, LA",39954,0,1320,56571,-16617,0.71
 2020,Lincoln,LA,"Lincoln, LA",42437,6,1127,48300,-5863,0.88
 2021,Lincoln,LA,"Lincoln, LA",45588,7,1405,60214,-14626,0.76
 2019,Lincoln,ME,"Lincoln, ME",52586,0,1662,71229,-18643,0.74
 2020,Lincoln,ME,"Lincoln, ME",55972,6,1674,71743,-15771,0.78
 2021,Lincoln,ME,"Lincoln, ME",59613,7,2176,93257,-33644,0.64
 2019,Lincoln,MN,"Lincoln, MN",46805,0,388,16629,30176,2.81
 2020,Lincoln,MN,"Lincoln, MN",51669,10,373,15986,35683,3.23
 2021,Lincoln,MN,"Lincoln, MN",57110,11,761,32614,24496,1.75
 2019,Lincoln,MO,"Lincoln, MO",42511,0,975,41786,725,1.02
 2020,Lincoln,MO,"Lincoln, MO",45097,6,943,40414,4683,1.12
 2021,Lincoln,MO,"Lincoln, MO",47686,6,1185,50786,-3100,0.94
 2019,Lincoln,MS,"Lincoln, MS",39236,0,787,33729,5507,1.16
 2020,Lincoln,MS,"Lincoln, MS",41755,6,805,34500,7255,1.21
 2021,Lincoln,MS,"Lincoln, MS",44688,7,790,33857,10831,1.32
 2019,Lincoln,MT,"Lincoln, MT",38977,0,1570,67286,-28309,0.58
 2020,Lincoln,MT,"Lincoln, MT",42915,10,1592,68229,-25314,0.63
 2021,Lincoln,MT,"Lincoln, MT",43782,2,2360,101143,-57361,0.43
 2019,Lincoln,NC,"Lincoln, NC",48419,0,1616,69257,-20838,0.7
 2020,Lincoln,NC,"Lincoln, NC",51675,7,1631,69900,-18225,0.74
 2021,Lincoln,NC,"Lincoln, NC",55368,7,1739,74529,-19161,0.74
 2019,Lincoln,NE,"Lincoln, NE",49617,0,808,34629,14988,1.43
 2020,Lincoln,NE,"Lincoln, NE",53436,8,883,37843,15593,1.41
 2021,Lincoln,NE,"Lincoln, NE",58484,9,771,33043,25441,1.77
 2019,Lincoln,NM,"Lincoln, NM",41684,0,1669,71529,-29845,0.58
 2020,Lincoln,NM,"Lincoln, NM",45210,9,1666,71400,-26190,0.63
 2021,Lincoln,NM,"Lincoln, NM",47703,6,2006,85971,-38268,0.55
 2019,Lincoln,NV,"Lincoln, NV",45484,0,741,31757,13727,1.43
 2020,Lincoln,NV,"Lincoln, NV",49336,9,956,40971,8365,1.2
 2021,Lincoln,NV,"Lincoln, NV",53269,8,1370,58714,-5445,0.91
 2019,Lincoln,OK,"Lincoln, OK",38990,0,691,29614,9376,1.32
 2020,Lincoln,OK,"Lincoln, OK",41876,7,605,25929,15947,1.62
 2021,Lincoln,OK,"Lincoln, OK",44687,7,1164,49886,-5199,0.9
 2019,Lincoln,OR,"Lincoln, OR",45542,0,1919,82243,-36701,0.55
 2020,Lincoln,OR,"Lincoln, OR",48876,7,1867,80014,-31138,0.61
 2021,Lincoln,OR,"Lincoln, OR",52482,7,2751,117900,-65418,0.45
 2019,Lincoln,SD,"Lincoln, SD",69978,0,1210,51857,18121,1.35
 2020,Lincoln,SD,"Lincoln, SD",73915,6,1287,55157,18758,1.34
 2021,Lincoln,SD,"Lincoln, SD",77245,5,1427,61157,16088,1.26
 2019,Lincoln,TN,"Lincoln, TN",41767,0,862,36943,4824,1.13
 2020,Lincoln,TN,"Lincoln, TN",44963,8,1146,49114,-4151,0.92
 2021,Lincoln,TN,"Lincoln, TN",48683,8,1221,52329,-3646,0.93
 2019,Lincoln,WA,"Lincoln, WA",45756,0,1239,53100,-7344,0.86
 2020,Lincoln,WA,"Lincoln, WA",50879,11,1577,67586,-16707,0.75
 2021,Lincoln,WA,"Lincoln, WA",51578,1,1664,71314,-19736,0.72
 2019,Lincoln,WI,"Lincoln, WI",45879,0,717,30729,15150,1.49
 2020,Lincoln,WI,"Lincoln, WI",49098,7,739,31671,17427,1.55
 2021,Lincoln,WI,"Lincoln, WI",51407,5,789,33814,17593,1.52
 2019,Lincoln,WV,"Lincoln, WV",31954,0,465,19929,12025,1.6
 2020,Lincoln,WV,"Lincoln, WV",34704,9,483,20700,14004,1.68
 2021,Lincoln,WV,"Lincoln, WV",37139,7,526,22543,14596,1.65
 2019,Lincoln,WY,"Lincoln, WY",49329,0,1717,73586,-24257,0.67
 2020,Lincoln,WY,"Lincoln, WY",54847,11,1687,72300,-17453,0.76
 2021,Lincoln,WY,"Lincoln, WY",61945,13,2995,128357,-66412,0.48
 2019,Linn,IA,"Linn, IA",53212,0,1084,46457,6755,1.15
 2020,Linn,IA,"Linn, IA",56373,6,1076,46114,10259,1.22
 2021,Linn,IA,"Linn, IA",59294,5,1181,50614,8680,1.17
 2019,Linn,KS,"Linn, KS",41329,0,441,18900,22429,2.19
 2020,Linn,KS,"Linn, KS",45515,10,380,16286,29229,2.79
 2021,Linn,KS,"Linn, KS",48383,6,794,34029,14354,1.42
 2019,Linn,MO,"Linn, MO",39614,0,435,18643,20971,2.12
 2020,Linn,MO,"Linn, MO",43234,9,449,19243,23991,2.25
 2021,Linn,MO,"Linn, MO",45966,6,615,26357,19609,1.74
 2019,Linn,OR,"Linn, OR",44501,0,1599,68529,-24028,0.65
 2020,Linn,OR,"Linn, OR",48357,9,1624,69600,-21243,0.69
 2021,Linn,OR,"Linn, OR",52695,9,2017,86443,-33748,0.61
 2019,Lipscomb,TX,"Lipscomb, TX",88722,0,485,20786,67936,4.27
 2020,Lipscomb,TX,"Lipscomb, TX",94821,7,509,21814,73007,4.35
 2021,Lipscomb,TX,"Lipscomb, TX",102569,8,413,17700,84869,5.79
 2019,Litchfield,CT,"Litchfield, CT",65789,0,1713,73414,-7625,0.9
 2020,Litchfield,CT,"Litchfield, CT",69700,6,1901,81471,-11771,0.86
 2021,Litchfield,CT,"Litchfield, CT",74852,7,2377,101871,-27019,0.73
 2019,Little River,AR,"Little River, AR",34511,0,682,29229,5282,1.18
 2020,Little River,AR,"Little River, AR",37360,8,547,23443,13917,1.59
 2021,Little River,AR,"Little River, AR",40794,9,853,36557,4237,1.12
 2019,Live Oak,TX,"Live Oak, TX",40618,0,1000,42857,-2239,0.95
 2020,Live Oak,TX,"Live Oak, TX",42590,5,745,31929,10661,1.33
 2021,Live Oak,TX,"Live Oak, TX",46134,8,1003,42986,3148,1.07
 2019,Livingston,IL,"Livingston, IL",45392,0,476,20400,24992,2.23
 2020,Livingston,IL,"Livingston, IL",52002,15,480,20571,31431,2.53
 2021,Livingston,IL,"Livingston, IL",57213,10,609,26100,31113,2.19
 2019,Livingston,KY,"Livingston, KY",39641,0,741,31757,7884,1.25
 2020,Livingston,KY,"Livingston, KY",44169,11,677,29014,15155,1.52
 2021,Livingston,KY,"Livingston, KY",47052,7,612,26229,20823,1.79
 2019,Livingston,LA,"Livingston, LA",43706,0,1037,44443,-737,0.98
 2020,Livingston,LA,"Livingston, LA",45974,5,1053,45129,845,1.02
 2021,Livingston,LA,"Livingston, LA",48854,6,1389,59529,-10675,0.82
 2019,Livingston,MI,"Livingston, MI",59309,0,1480,63429,-4120,0.94
 2020,Livingston,MI,"Livingston, MI",62640,6,1619,69386,-6746,0.9
 2021,Livingston,MI,"Livingston, MI",65883,5,1764,75600,-9717,0.87
 2019,Livingston,MO,"Livingston, MO",39106,0,430,18429,20677,2.12
 2020,Livingston,MO,"Livingston, MO",43802,12,450,19286,24516,2.27
 2021,Livingston,MO,"Livingston, MO",46069,5,577,24729,21340,1.86
 2019,Livingston,NY,"Livingston, NY",46803,0,710,30429,16374,1.54
 2020,Livingston,NY,"Livingston, NY",49549,6,732,31371,18178,1.58
 2021,Livingston,NY,"Livingston, NY",52209,5,914,39171,13038,1.33
 2019,Llano,TX,"Llano, TX",54046,0,2416,103543,-49497,0.52
 2020,Llano,TX,"Llano, TX",56744,5,2516,107829,-51085,0.53
 2021,Llano,TX,"Llano, TX",59689,5,3430,147000,-87311,0.41
 2019,Logan,AR,"Logan, AR",33216,0,570,24429,8787,1.36
 2020,Logan,AR,"Logan, AR",35348,6,615,26357,8991,1.34
 2021,Logan,AR,"Logan, AR",39622,12,647,27729,11893,1.43
 2019,Logan,CO,"Logan, CO",43230,0,899,38529,4701,1.12
 2020,Logan,CO,"Logan, CO",44239,2,1093,46843,-2604,0.94
 2021,Logan,CO,"Logan, CO",48330,9,1085,46500,1830,1.04
 2019,Logan,IL,"Logan, IL",37877,0,488,20914,16963,1.81
 2020,Logan,IL,"Logan, IL",42169,11,458,19629,22540,2.15
 2021,Logan,IL,"Logan, IL",47074,12,487,20871,26203,2.26
 2019,Logan,KS,"Logan, KS",48342,0,660,28286,20056,1.71
 2020,Logan,KS,"Logan, KS",58592,21,649,27814,30778,2.11
 2021,Logan,KS,"Logan, KS",63461,8,572,24514,38947,2.59
 2019,Logan,KY,"Logan, KY",37418,0,665,28500,8918,1.31
 2020,Logan,KY,"Logan, KY",40765,9,839,35957,4808,1.13
 2021,Logan,KY,"Logan, KY",45732,12,1024,43886,1846,1.04
 2019,Logan,ND,"Logan, ND",50471,0,373,15986,34485,3.16
 2020,Logan,ND,"Logan, ND",60170,19,343,14700,45470,4.09
 2021,Logan,ND,"Logan, ND",68365,14,187,8014,60351,8.53
 2019,Logan,NE,"Logan, NE",52031,0,610,26143,25888,1.99
 2020,Logan,NE,"Logan, NE",57256,10,561,24043,33213,2.38
 2021,Logan,NE,"Logan, NE",60186,5,667,28586,31600,2.11
 2019,Logan,OH,"Logan, OH",42969,0,756,32400,10569,1.33
 2020,Logan,OH,"Logan, OH",47329,10,773,33129,14200,1.43
 2021,Logan,OH,"Logan, OH",50151,6,958,41057,9094,1.22
 2019,Logan,OK,"Logan, OK",44296,0,1229,52671,-8375,0.84
 2020,Logan,OK,"Logan, OK",45694,3,1227,52586,-6892,0.87
 2021,Logan,OK,"Logan, OK",48559,6,1535,65786,-17227,0.74
 2019,Logan,WV,"Logan, WV",37531,0,519,22243,15288,1.69
 2020,Logan,WV,"Logan, WV",40353,8,575,24643,15710,1.64
 2021,Logan,WV,"Logan, WV",43764,9,683,29271,14493,1.5
 2019,Long,GA,"Long, GA",33714,0,874,37457,-3743,0.9
 2020,Long,GA,"Long, GA",36566,9,982,42086,-5520,0.87
 2021,Long,GA,"Long, GA",38480,5,1409,60386,-21906,0.64
 2019,Lonoke,AR,"Lonoke, AR",40743,0,804,34457,6286,1.18
 2020,Lonoke,AR,"Lonoke, AR",43681,7,827,35443,8238,1.23
 2021,Lonoke,AR,"Lonoke, AR",46388,6,963,41271,5117,1.12
 2019,Lorain,OH,"Lorain, OH",48387,0,913,39129,9258,1.24
 2020,Lorain,OH,"Lorain, OH",51518,7,832,35657,15861,1.44
 2021,Lorain,OH,"Lorain, OH",54452,6,886,37971,16481,1.43
 2019,Los Alamos,NM,"Los Alamos, NM",72366,0,1900,81429,-9063,0.89
 2020,Los Alamos,NM,"Los Alamos, NM",75949,5,1887,80871,-4922,0.94
 2021,Los Alamos,NM,"Los Alamos, NM",81306,7,2102,90086,-8780,0.9
 2019,Los Angeles,CA,"Los Angeles, CA",63252,0,3431,147043,-83791,0.43
 2020,Los Angeles,CA,"Los Angeles, CA",68541,8,4049,173529,-104988,0.39
 2021,Los Angeles,CA,"Los Angeles, CA",74141,8,4309,184671,-110530,0.4
 2019,Loudon,TN,"Loudon, TN",54449,0,1750,75000,-20551,0.73
 2020,Loudon,TN,"Loudon, TN",57594,6,1805,77357,-19763,0.74
 2021,Loudon,TN,"Loudon, TN",60642,5,2318,99343,-38701,0.61
 2019,Loudoun,VA,"Loudoun, VA",82681,0,3013,129129,-46448,0.64
 2020,Loudoun,VA,"Loudoun, VA",85568,4,3203,137271,-51703,0.62
 2021,Loudoun,VA,"Loudoun, VA",90254,6,3217,137871,-47617,0.65
 2019,Louisa,IA,"Louisa, IA",43840,0,696,29829,14011,1.47
 2020,Louisa,IA,"Louisa, IA",45420,4,718,30771,14649,1.48
 2021,Louisa,IA,"Louisa, IA",50885,12,689,29529,21356,1.72
 2019,Louisa,VA,"Louisa, VA",44759,0,1548,66343,-21584,0.67
 2020,Louisa,VA,"Louisa, VA",47474,6,1546,66257,-18783,0.72
 2021,Louisa,VA,"Louisa, VA",50089,6,1875,80357,-30268,0.62
 2019,Loup,NE,"Loup, NE",58268,0,1217,52157,6111,1.12
 2020,Loup,NE,"Loup, NE",65201,12,1175,50357,14844,1.29
 2021,Loup,NE,"Loup, NE",69695,7,1626,69686,9,1
 2019,Love,OK,"Love, OK",39229,0,727,31157,8072,1.26
 2020,Love,OK,"Love, OK",41135,5,872,37371,3764,1.1
 2021,Love,OK,"Love, OK",43592,6,952,40800,2792,1.07
 2019,Lowndes,AL,"Lowndes, AL",40270,0,755,32357,7913,1.24
 2020,Lowndes,AL,"Lowndes, AL",43398,8,828,35486,7912,1.22
 2021,Lowndes,AL,"Lowndes, AL",48852,13,608,26057,22795,1.87
 2019,Lowndes,GA,"Lowndes, GA",38070,0,848,36343,1727,1.05
 2020,Lowndes,GA,"Lowndes, GA",41037,8,887,38014,3023,1.08
 2021,Lowndes,GA,"Lowndes, GA",43546,6,1081,46329,-2783,0.94
 2019,Lowndes,MS,"Lowndes, MS",40592,0,761,32614,7978,1.24
 2020,Lowndes,MS,"Lowndes, MS",44039,9,923,39557,4482,1.11
 2021,Lowndes,MS,"Lowndes, MS",47137,7,987,42300,4837,1.11
 2019,Lubbock,TX,"Lubbock, TX",45696,0,1080,46286,-590,0.99
 2020,Lubbock,TX,"Lubbock, TX",47931,5,1147,49157,-1226,0.98
 2021,Lubbock,TX,"Lubbock, TX",50881,6,1397,59871,-8990,0.85
 2019,Lucas,IA,"Lucas, IA",41923,0,577,24729,17194,1.7
 2020,Lucas,IA,"Lucas, IA",44451,6,576,24686,19765,1.8
 2021,Lucas,IA,"Lucas, IA",47774,8,726,31114,16660,1.54
 2019,Lucas,OH,"Lucas, OH",47730,0,601,25757,21973,1.85
 2020,Lucas,OH,"Lucas, OH",51088,7,645,27643,23445,1.85
 2021,Lucas,OH,"Lucas, OH",54105,6,646,27686,26419,1.95
 2019,Luce,MI,"Luce, MI",35772,0,473,20271,15501,1.76
 2020,Luce,MI,"Luce, MI",41624,16,336,14400,27224,2.89
 2021,Luce,MI,"Luce, MI",43526,5,758,32486,11040,1.34
 2019,Lumpkin,GA,"Lumpkin, GA",39977,0,1408,60343,-20366,0.66
 2020,Lumpkin,GA,"Lumpkin, GA",42280,6,1585,67929,-25649,0.62
 2021,Lumpkin,GA,"Lumpkin, GA",44843,6,1956,83829,-38986,0.53
 2019,Luna,NM,"Luna, NM",31164,0,625,26786,4378,1.16
 2020,Luna,NM,"Luna, NM",35385,14,680,29143,6242,1.21
 2021,Luna,NM,"Luna, NM",38494,9,800,34286,4208,1.12
 2019,Lunenburg,VA,"Lunenburg, VA",33635,0,641,27471,6164,1.22
 2020,Lunenburg,VA,"Lunenburg, VA",36859,10,638,27343,9516,1.35
 2021,Lunenburg,VA,"Lunenburg, VA",40149,9,1201,51471,-11322,0.78
 2019,Luzerne,PA,"Luzerne, PA",44987,0,673,28843,16144,1.56
 2020,Luzerne,PA,"Luzerne, PA",49172,9,687,29443,19729,1.67
 2021,Luzerne,PA,"Luzerne, PA",52300,6,803,34414,17886,1.52
 2019,Lycoming,PA,"Lycoming, PA",44394,0,760,32571,11823,1.36
 2020,Lycoming,PA,"Lycoming, PA",48075,8,752,32229,15846,1.49
 2021,Lycoming,PA,"Lycoming, PA",50464,5,819,35100,15364,1.44
 2019,Lyman,SD,"Lyman, SD",42109,0,780,33429,8680,1.26
 2020,Lyman,SD,"Lyman, SD",47700,13,826,35400,12300,1.35
 2021,Lyman,SD,"Lyman, SD",57365,20,815,34929,22436,1.64
 2019,Lynn,TX,"Lynn, TX",46708,0,1336,57257,-10549,0.82
 2020,Lynn,TX,"Lynn, TX",43995,-6,1191,51043,-7048,0.86
 2021,Lynn,TX,"Lynn, TX",58496,33,842,36086,22410,1.62
 2019,Lyon,IA,"Lyon, IA",56964,0,1132,48514,8450,1.17
 2020,Lyon,IA,"Lyon, IA",56596,-1,882,37800,18796,1.5
 2021,Lyon,IA,"Lyon, IA",61551,9,1164,49886,11665,1.23
 2019,Lyon,KS,"Lyon, KS",39896,0,609,26100,13796,1.53
 2020,Lyon,KS,"Lyon, KS",44157,11,563,24129,20028,1.83
 2021,Lyon,KS,"Lyon, KS",46177,5,601,25757,20420,1.79
 2019,Lyon,KY,"Lyon, KY",35856,0,1267,54300,-18444,0.66
 2020,Lyon,KY,"Lyon, KY",39460,10,1310,56143,-16683,0.7
 2021,Lyon,KY,"Lyon, KY",41762,6,1942,83229,-41467,0.5
 2019,Lyon,MN,"Lyon, MN",49751,0,692,29657,20094,1.68
 2020,Lyon,MN,"Lyon, MN",55067,11,604,25886,29181,2.13
 2021,Lyon,MN,"Lyon, MN",58433,6,744,31886,26547,1.83
 2019,Lyon,NV,"Lyon, NV",40283,0,1532,65657,-25374,0.61
 2020,Lyon,NV,"Lyon, NV",44043,9,1624,69600,-25557,0.63
 2021,Lyon,NV,"Lyon, NV",48247,10,2009,86100,-37853,0.56
 2019,Mackinac,MI,"Mackinac, MI",44726,0,881,37757,6969,1.18
 2020,Mackinac,MI,"Mackinac, MI",50473,13,829,35529,14944,1.42
 2021,Mackinac,MI,"Mackinac, MI",53230,6,1037,44443,8787,1.2
 2019,Macomb,MI,"Macomb, MI",47350,0,1044,44743,2607,1.06
 2020,Macomb,MI,"Macomb, MI",51798,9,1062,45514,6284,1.14
 2021,Macomb,MI,"Macomb, MI",54258,5,1061,45471,8787,1.19
 2019,Macon,AL,"Macon, AL",31670,0,299,12814,18856,2.47
 2020,Macon,AL,"Macon, AL",34888,10,515,22071,12817,1.58
 2021,Macon,AL,"Macon, AL",38412,10,618,26486,11926,1.45
 2019,Macon,GA,"Macon, GA",33395,0,318,13629,19766,2.45
 2020,Macon,GA,"Macon, GA",35669,7,443,18986,16683,1.88
 2021,Macon,GA,"Macon, GA",39164,10,767,32871,6293,1.19
 2019,Macon,IL,"Macon, IL",47492,0,485,20786,26706,2.28
 2020,Macon,IL,"Macon, IL",51804,9,484,20743,31061,2.5
 2021,Macon,IL,"Macon, IL",56548,9,498,21343,35205,2.65
 2019,Macon,MO,"Macon, MO",41152,0,644,27600,13552,1.49
 2020,Macon,MO,"Macon, MO",44838,9,792,33943,10895,1.32
 2021,Macon,MO,"Macon, MO",47691,6,476,20400,27291,2.34
 2019,Macon,NC,"Macon, NC",41975,0,1792,76800,-34825,0.55
 2020,Macon,NC,"Macon, NC",45095,7,1715,73500,-28405,0.61
 2021,Macon,NC,"Macon, NC",48875,8,3258,139629,-90754,0.35
 2019,Macon,TN,"Macon, TN",33618,0,880,37714,-4096,0.89
 2020,Macon,TN,"Macon, TN",35659,6,914,39171,-3512,0.91
 2021,Macon,TN,"Macon, TN",39669,11,1372,58800,-19131,0.67
 2019,Macoupin,IL,"Macoupin, IL",41774,0,400,17143,24631,2.44
 2020,Macoupin,IL,"Macoupin, IL",45687,9,403,17271,28416,2.65
 2021,Macoupin,IL,"Macoupin, IL",49950,9,464,19886,30064,2.51
 2019,Madera,CA,"Madera, CA",39388,0,1571,67329,-27941,0.59
 2020,Madera,CA,"Madera, CA",44072,12,1640,70286,-26214,0.63
 2021,Madera,CA,"Madera, CA",45757,4,2017,86443,-40686,0.53
 2019,Madison,AL,"Madison, AL",53160,0,1260,54000,-840,0.98
 2020,Madison,AL,"Madison, AL",56499,6,1412,60514,-4015,0.93
 2021,Madison,AL,"Madison, AL",59852,6,1714,73457,-13605,0.81
 2019,Madison,AR,"Madison, AR",34040,0,1087,46586,-12546,0.73
 2020,Madison,AR,"Madison, AR",34782,2,906,38829,-4047,0.9
 2021,Madison,AR,"Madison, AR",40884,18,1202,51514,-10630,0.79
 2019,Madison,FL,"Madison, FL",33602,0,955,40929,-7327,0.82
 2020,Madison,FL,"Madison, FL",36338,8,830,35571,767,1.02
 2021,Madison,FL,"Madison, FL",39165,8,1207,51729,-12564,0.76
 2019,Madison,GA,"Madison, GA",38459,0,1040,44571,-6112,0.86
 2020,Madison,GA,"Madison, GA",39298,2,1196,51257,-11959,0.77
 2021,Madison,GA,"Madison, GA",43445,11,1576,67543,-24098,0.64
 2019,Madison,IA,"Madison, IA",50472,0,1133,48557,1915,1.04
 2020,Madison,IA,"Madison, IA",53555,6,1053,45129,8426,1.19
 2021,Madison,IA,"Madison, IA",57263,7,1356,58114,-851,0.99
 2019,Madison,ID,"Madison, ID",22650,0,1366,58543,-35893,0.39
 2020,Madison,ID,"Madison, ID",24244,7,1403,60129,-35885,0.4
 2021,Madison,ID,"Madison, ID",25648,6,2403,102986,-77338,0.25
 2019,Madison,IL,"Madison, IL",48409,0,612,26229,22180,1.85
 2020,Madison,IL,"Madison, IL",51846,7,558,23914,27932,2.17
 2021,Madison,IL,"Madison, IL",55538,7,647,27729,27809,2
 2019,Madison,IN,"Madison, IN",39056,0,433,18557,20499,2.1
 2020,Madison,IN,"Madison, IN",42185,8,496,21257,20928,1.98
 2021,Madison,IN,"Madison, IN",45755,9,733,31414,14341,1.46
 2019,Madison,KY,"Madison, KY",36997,0,1017,43586,-6589,0.85
 2020,Madison,KY,"Madison, KY",40275,9,1073,45986,-5711,0.88
 2021,Madison,KY,"Madison, KY",42808,6,1287,55157,-12349,0.78
 2019,Madison,LA,"Madison, LA",34545,0,344,14743,19802,2.34
 2020,Madison,LA,"Madison, LA",41229,19,884,37886,3343,1.09
 2021,Madison,LA,"Madison, LA",44828,9,599,25671,19157,1.75
 2019,Madison,MO,"Madison, MO",36166,0,542,23229,12937,1.56
 2020,Madison,MO,"Madison, MO",39546,9,596,25543,14003,1.55
 2021,Madison,MO,"Madison, MO",41068,4,754,32314,8754,1.27
 2019,Madison,MS,"Madison, MS",65464,0,1762,75514,-10050,0.87
 2020,Madison,MS,"Madison, MS",69925,7,1894,81171,-11246,0.86
 2021,Madison,MS,"Madison, MS",73485,5,2435,104357,-30872,0.7
 2019,Madison,MT,"Madison, MT",66750,0,3192,136800,-70050,0.49
 2020,Madison,MT,"Madison, MT",70067,5,3662,156943,-86876,0.45
 2021,Madison,MT,"Madison, MT",74468,6,3099,132814,-58346,0.56
 2019,Madison,NC,"Madison, NC",37206,0,1563,66986,-29780,0.56
 2020,Madison,NC,"Madison, NC",39775,7,1744,74743,-34968,0.53
 2021,Madison,NC,"Madison, NC",43064,8,2078,89057,-45993,0.48
 2019,Madison,NE,"Madison, NE",51683,0,956,40971,10712,1.26
 2020,Madison,NE,"Madison, NE",55695,8,1051,45043,10652,1.24
 2021,Madison,NE,"Madison, NE",60169,8,1302,55800,4369,1.08
 2019,Madison,NY,"Madison, NY",48065,0,895,38357,9708,1.25
 2020,Madison,NY,"Madison, NY",51732,8,915,39214,12518,1.32
 2021,Madison,NY,"Madison, NY",54766,6,1012,43371,11395,1.26
 2019,Madison,OH,"Madison, OH",42785,0,990,42429,356,1.01
 2020,Madison,OH,"Madison, OH",47359,11,1047,44871,2488,1.06
 2021,Madison,OH,"Madison, OH",50124,6,1470,63000,-12876,0.8
 2019,Madison,TN,"Madison, TN",43975,0,751,32186,11789,1.37
 2020,Madison,TN,"Madison, TN",47357,8,851,36471,10886,1.3
 2021,Madison,TN,"Madison, TN",51004,8,1039,44529,6475,1.15
 2019,Madison,TX,"Madison, TX",34029,0,1113,47700,-13671,0.71
 2020,Madison,TX,"Madison, TX",36888,8,1577,67586,-30698,0.55
 2021,Madison,TX,"Madison, TX",40859,11,1011,43329,-2470,0.94
 2019,Madison,VA,"Madison, VA",48543,0,1603,68700,-20157,0.71
 2020,Madison,VA,"Madison, VA",51692,7,1651,70757,-19065,0.73
 2021,Madison,VA,"Madison, VA",55148,7,1655,70929,-15781,0.78
 2019,Magoffin,KY,"Magoffin, KY",34157,0,662,28371,5786,1.2
 2020,Magoffin,KY,"Magoffin, KY",39470,16,498,21343,18127,1.85
 2021,Magoffin,KY,"Magoffin, KY",43913,11,861,36900,7013,1.19
 2019,Mahaska,IA,"Mahaska, IA",43318,0,598,25629,17689,1.69
 2020,Mahaska,IA,"Mahaska, IA",45828,6,671,28757,17071,1.59
 2021,Mahaska,IA,"Mahaska, IA",49933,9,667,28586,21347,1.75
 2019,Mahnomen,MN,"Mahnomen, MN",34548,0,627,26871,7677,1.29
 2020,Mahnomen,MN,"Mahnomen, MN",41569,20,656,28114,13455,1.48
 2021,Mahnomen,MN,"Mahnomen, MN",47898,15,610,26143,21755,1.83
 2019,Mahoning,OH,"Mahoning, OH",44241,0,613,26271,17970,1.68
 2020,Mahoning,OH,"Mahoning, OH",47903,8,622,26657,21246,1.8
 2021,Mahoning,OH,"Mahoning, OH",50968,6,584,25029,25939,2.04
 2019,Major,OK,"Major, OK",42600,0,704,30171,12429,1.41
 2020,Major,OK,"Major, OK",43220,2,705,30214,13006,1.43
 2021,Major,OK,"Major, OK",47185,9,427,18300,28885,2.58
 2019,Malheur,OR,"Malheur, OR",32651,0,1048,44914,-12263,0.73
 2020,Malheur,OR,"Malheur, OR",35489,9,1071,45900,-10411,0.77
 2021,Malheur,OR,"Malheur, OR",38923,10,1638,70200,-31277,0.55
 2019,Manatee,FL,"Manatee, FL",53269,0,1715,73500,-20231,0.72
 2020,Manatee,FL,"Manatee, FL",55550,4,1708,73200,-17650,0.76
 2021,Manatee,FL,"Manatee, FL",59152,7,2414,103457,-44305,0.57
 2019,Manistee,MI,"Manistee, MI",40528,0,1074,46029,-5501,0.88
 2020,Manistee,MI,"Manistee, MI",44375,10,1021,43757,618,1.01
 2021,Manistee,MI,"Manistee, MI",46489,5,1292,55371,-8882,0.84
 2019,Manitowoc,WI,"Manitowoc, WI",47097,0,649,27814,19283,1.69
 2020,Manitowoc,WI,"Manitowoc, WI",50242,7,669,28671,21571,1.75
 2021,Manitowoc,WI,"Manitowoc, WI",53085,6,824,35314,17771,1.5
 2019,Marathon,WI,"Marathon, WI",52045,0,1020,43714,8331,1.19
 2020,Marathon,WI,"Marathon, WI",55055,6,976,41829,13226,1.32
 2021,Marathon,WI,"Marathon, WI",58096,6,1252,53657,4439,1.08
 2019,Marengo,AL,"Marengo, AL",39394,0,648,27771,11623,1.42
 2020,Marengo,AL,"Marengo, AL",43596,11,679,29100,14496,1.5
 2021,Marengo,AL,"Marengo, AL",47008,8,718,30771,16237,1.53
 2019,Maricopa,AZ,"Maricopa, AZ",52032,0,1781,76329,-24297,0.68
 2020,Maricopa,AZ,"Maricopa, AZ",56255,8,2046,87686,-31431,0.64
 2021,Maricopa,AZ,"Maricopa, AZ",59759,6,2430,104143,-44384,0.57
 2019,Maries,MO,"Maries, MO",36105,0,750,32143,3962,1.12
 2020,Maries,MO,"Maries, MO",39120,8,800,34286,4834,1.14
 2021,Maries,MO,"Maries, MO",41212,5,939,40243,969,1.02
 2019,Marin,CA,"Marin, CA",139891,0,6299,269957,-130066,0.52
 2020,Marin,CA,"Marin, CA",148419,6,6751,289329,-140910,0.51
 2021,Marin,CA,"Marin, CA",164118,11,6570,281571,-117453,0.58
 2019,Marinette,WI,"Marinette, WI",45231,0,622,26657,18574,1.7
 2020,Marinette,WI,"Marinette, WI",47829,6,667,28586,19243,1.67
 2021,Marinette,WI,"Marinette, WI",51265,7,740,31714,19551,1.62
 2019,Marion,AL,"Marion, AL",33714,0,585,25071,8643,1.34
 2020,Marion,AL,"Marion, AL",36927,10,681,29186,7741,1.27
 2021,Marion,AL,"Marion, AL",40939,11,666,28543,12396,1.43
 2019,Marion,AR,"Marion, AR",31484,0,835,35786,-4302,0.88
 2020,Marion,AR,"Marion, AR",33925,8,950,40714,-6789,0.83
 2021,Marion,AR,"Marion, AR",36684,8,1237,53014,-16330,0.69
 2019,Marion,FL,"Marion, FL",39153,0,956,40971,-1818,0.96
 2020,Marion,FL,"Marion, FL",41960,7,992,42514,-554,0.99
 2021,Marion,FL,"Marion, FL",45152,8,1356,58114,-12962,0.78
 2019,Marion,GA,"Marion, GA",32765,0,825,35357,-2592,0.93
 2020,Marion,GA,"Marion, GA",35290,8,1030,44143,-8853,0.8
 2021,Marion,GA,"Marion, GA",39075,11,1135,48643,-9568,0.8
 2019,Marion,IA,"Marion, IA",50249,0,905,38786,11463,1.3
 2020,Marion,IA,"Marion, IA",53316,6,979,41957,11359,1.27
 2021,Marion,IA,"Marion, IA",56989,7,1404,60171,-3182,0.95
 2019,Marion,IL,"Marion, IL",42172,0,515,22071,20101,1.91
 2020,Marion,IL,"Marion, IL",46572,10,532,22800,23772,2.04
 2021,Marion,IL,"Marion, IL",50107,8,734,31457,18650,1.59
 2019,Marion,IN,"Marion, IN",55588,0,949,40671,14917,1.37
 2020,Marion,IN,"Marion, IN",60608,9,973,41700,18908,1.45
 2021,Marion,IN,"Marion, IN",65625,8,1129,48386,17239,1.36
 2019,Marion,KS,"Marion, KS",42134,0,409,17529,24605,2.4
 2020,Marion,KS,"Marion, KS",46843,11,493,21129,25714,2.22
 2021,Marion,KS,"Marion, KS",49005,5,555,23786,25219,2.06
 2019,Marion,KY,"Marion, KY",37396,0,687,29443,7953,1.27
 2020,Marion,KY,"Marion, KY",40610,9,815,34929,5681,1.16
 2021,Marion,KY,"Marion, KY",43909,8,1087,46586,-2677,0.94
 2019,Marion,MO,"Marion, MO",41063,0,716,30686,10377,1.34
 2020,Marion,MO,"Marion, MO",44348,8,583,24986,19362,1.77
 2021,Marion,MO,"Marion, MO",47304,7,635,27214,20090,1.74
 2019,Marion,MS,"Marion, MS",38807,0,727,31157,7650,1.25
 2020,Marion,MS,"Marion, MS",40203,4,675,28929,11274,1.39
 2021,Marion,MS,"Marion, MS",43035,7,854,36600,6435,1.18
 2019,Marion,OH,"Marion, OH",37356,0,374,16029,21327,2.33
 2020,Marion,OH,"Marion, OH",40780,9,421,18043,22737,2.26
 2021,Marion,OH,"Marion, OH",43814,7,573,24557,19257,1.78
 2019,Marion,OR,"Marion, OR",44921,0,1750,75000,-30079,0.6
 2020,Marion,OR,"Marion, OR",49022,9,1938,83057,-34035,0.59
 2021,Marion,OR,"Marion, OR",53791,10,2120,90857,-37066,0.59
 2019,Marion,SC,"Marion, SC",34745,0,477,20443,14302,1.7
 2020,Marion,SC,"Marion, SC",37956,9,545,23357,14599,1.63
 2021,Marion,SC,"Marion, SC",41519,9,616,26400,15119,1.57
 2019,Marion,TN,"Marion, TN",40301,0,1101,47186,-6885,0.85
 2020,Marion,TN,"Marion, TN",43088,7,1025,43929,-841,0.98
 2021,Marion,TN,"Marion, TN",46559,8,1611,69043,-22484,0.67
 2019,Marion,TX,"Marion, TX",42643,0,825,35357,7286,1.21
 2020,Marion,TX,"Marion, TX",43840,3,906,38829,5011,1.13
 2021,Marion,TX,"Marion, TX",47582,9,1038,44486,3096,1.07
 2019,Marion,WV,"Marion, WV",43460,0,687,29443,14017,1.48
 2020,Marion,WV,"Marion, WV",45569,5,613,26271,19298,1.73
 2021,Marion,WV,"Marion, WV",48343,6,648,27771,20572,1.74
 2019,Mariposa,CA,"Mariposa, CA",54375,0,1797,77014,-22639,0.71
 2020,Mariposa,CA,"Mariposa, CA",57964,7,2030,87000,-29036,0.67
 2021,Mariposa,CA,"Mariposa, CA",61343,6,2312,99086,-37743,0.62
 2019,Marlboro,SC,"Marlboro, SC",31256,0,363,15557,15699,2.01
 2020,Marlboro,SC,"Marlboro, SC",34189,9,400,17143,17046,1.99
 2021,Marlboro,SC,"Marlboro, SC",37933,11,679,29100,8833,1.3
 2019,Marquette,MI,"Marquette, MI",40494,0,906,38829,1665,1.04
 2020,Marquette,MI,"Marquette, MI",44933,11,890,38143,6790,1.18
 2021,Marquette,MI,"Marquette, MI",47870,7,1047,44871,2999,1.07
 2019,Marquette,WI,"Marquette, WI",43032,0,702,30086,12946,1.43
 2020,Marquette,WI,"Marquette, WI",45977,7,860,36857,9120,1.25
 2021,Marquette,WI,"Marquette, WI",47885,4,900,38571,9314,1.24
 2019,Marshall,AL,"Marshall, AL",37819,0,1086,46543,-8724,0.81
 2020,Marshall,AL,"Marshall, AL",40676,8,1110,47571,-6895,0.86
 2021,Marshall,AL,"Marshall, AL",44416,9,1311,56186,-11770,0.79
 2019,Marshall,IA,"Marshall, IA",43213,0,561,24043,19170,1.8
 2020,Marshall,IA,"Marshall, IA",47059,9,612,26229,20830,1.79
 2021,Marshall,IA,"Marshall, IA",50776,8,581,24900,25876,2.04
 2019,Marshall,IL,"Marshall, IL",44084,0,586,25114,18970,1.76
 2020,Marshall,IL,"Marshall, IL",49305,12,485,20786,28519,2.37
 2021,Marshall,IL,"Marshall, IL",54239,10,597,25586,28653,2.12
 2019,Marshall,IN,"Marshall, IN",42506,0,904,38743,3763,1.1
 2020,Marshall,IN,"Marshall, IN",46031,8,905,38786,7245,1.19
 2021,Marshall,IN,"Marshall, IN",51474,12,1041,44614,6860,1.15
 2019,Marshall,KS,"Marshall, KS",42940,0,452,19371,23569,2.22
 2020,Marshall,KS,"Marshall, KS",48437,13,374,16029,32408,3.02
 2021,Marshall,KS,"Marshall, KS",50995,5,520,22286,28709,2.29
 2019,Marshall,KY,"Marshall, KY",42695,0,815,34929,7766,1.22
 2020,Marshall,KY,"Marshall, KY",46261,8,915,39214,7047,1.18
 2021,Marshall,KY,"Marshall, KY",48292,4,1298,55629,-7337,0.87
 2019,Marshall,MN,"Marshall, MN",50621,0,602,25800,24821,1.96
 2020,Marshall,MN,"Marshall, MN",63411,25,606,25971,37440,2.44
 2021,Marshall,MN,"Marshall, MN",68963,9,879,37671,31292,1.83
 2019,Marshall,MS,"Marshall, MS",36435,0,875,37500,-1065,0.97
 2020,Marshall,MS,"Marshall, MS",39947,10,1030,44143,-4196,0.9
 2021,Marshall,MS,"Marshall, MS",43724,10,1484,63600,-19876,0.69
 2019,Marshall,OK,"Marshall, OK",37863,0,1099,47100,-9237,0.8
 2020,Marshall,OK,"Marshall, OK",41119,9,1333,57129,-16010,0.72
 2021,Marshall,OK,"Marshall, OK",43325,5,1455,62357,-19032,0.69
 2019,Marshall,SD,"Marshall, SD",54896,0,1280,54857,39,1
 2020,Marshall,SD,"Marshall, SD",71354,30,1406,60257,11097,1.18
 2021,Marshall,SD,"Marshall, SD",72571,2,1472,63086,9485,1.15
 2019,Marshall,TN,"Marshall, TN",40704,0,1129,48386,-7682,0.84
 2020,Marshall,TN,"Marshall, TN",43516,7,1297,55586,-12070,0.78
 2021,Marshall,TN,"Marshall, TN",47446,9,1451,62186,-14740,0.76
 2019,Marshall,WV,"Marshall, WV",42578,0,564,24171,18407,1.76
 2020,Marshall,WV,"Marshall, WV",43761,3,537,23014,20747,1.9
 2021,Marshall,WV,"Marshall, WV",47456,8,526,22543,24913,2.11
 2019,Martin,FL,"Martin, FL",92323,0,1984,85029,7294,1.09
 2020,Martin,FL,"Martin, FL",95026,3,1953,83700,11326,1.14
 2021,Martin,FL,"Martin, FL",102273,8,2833,121414,-19141,0.84
 2019,Martin,IN,"Martin, IN",40765,0,653,27986,12779,1.46
 2020,Martin,IN,"Martin, IN",45326,11,711,30471,14855,1.49
 2021,Martin,IN,"Martin, IN",49082,8,989,42386,6696,1.16
 2019,Martin,KY,"Martin, KY",28512,0,486,20829,7683,1.37
 2020,Martin,KY,"Martin, KY",32984,16,411,17614,15370,1.87
 2021,Martin,KY,"Martin, KY",35932,9,340,14571,21361,2.47
 2019,Martin,MN,"Martin, MN",51498,0,461,19757,31741,2.61
 2020,Martin,MN,"Martin, MN",55701,8,640,27429,28272,2.03
 2021,Martin,MN,"Martin, MN",61216,10,637,27300,33916,2.24
 2019,Martin,NC,"Martin, NC",35954,0,383,16414,19540,2.19
 2020,Martin,NC,"Martin, NC",38674,8,539,23100,15574,1.67
 2021,Martin,NC,"Martin, NC",43176,12,490,21000,22176,2.06
 2019,Martin,TX,"Martin, TX",78790,0,1280,54857,23933,1.44
 2020,Martin,TX,"Martin, TX",73094,-7,1592,68229,4865,1.07
 2021,Martin,TX,"Martin, TX",84121,15,1413,60557,23564,1.39
 2019,Mason,IL,"Mason, IL",41671,0,376,16114,25557,2.59
 2020,Mason,IL,"Mason, IL",47241,13,346,14829,32412,3.19
 2021,Mason,IL,"Mason, IL",53655,14,295,12643,41012,4.24
 2019,Mason,KY,"Mason, KY",40268,0,515,22071,18197,1.82
 2020,Mason,KY,"Mason, KY",44145,10,598,25629,18516,1.72
 2021,Mason,KY,"Mason, KY",47927,9,931,39900,8027,1.2
 2019,Mason,MI,"Mason, MI",41900,0,887,38014,3886,1.1
 2020,Mason,MI,"Mason, MI",46365,11,1115,47786,-1421,0.97
 2021,Mason,MI,"Mason, MI",48733,5,1378,59057,-10324,0.83
 2019,Mason,TX,"Mason, TX",50721,0,852,36514,14207,1.39
 2020,Mason,TX,"Mason, TX",52617,4,2194,94029,-41412,0.56
 2021,Mason,TX,"Mason, TX",57094,9,1858,79629,-22535,0.72
 2019,Mason,WA,"Mason, WA",45120,0,1463,62700,-17580,0.72
 2020,Mason,WA,"Mason, WA",48488,8,1504,64457,-15969,0.75
 2021,Mason,WA,"Mason, WA",52410,8,2242,96086,-43676,0.55
 2019,Mason,WV,"Mason, WV",36236,0,598,25629,10607,1.41
 2020,Mason,WV,"Mason, WV",39138,8,541,23186,15952,1.69
 2021,Mason,WV,"Mason, WV",42126,8,735,31500,10626,1.34
 2019,Massac,IL,"Massac, IL",38294,0,413,17700,20594,2.16
 2020,Massac,IL,"Massac, IL",42411,11,420,18000,24411,2.36
 2021,Massac,IL,"Massac, IL",46618,10,385,16500,30118,2.83
 2019,Matagorda,TX,"Matagorda, TX",45851,0,1046,44829,1022,1.02
 2020,Matagorda,TX,"Matagorda, TX",47528,4,1002,42943,4585,1.11
 2021,Matagorda,TX,"Matagorda, TX",50775,7,1009,43243,7532,1.17
 2019,Matanuska-susitna,AK,"Matanuska-susitna, AK",50459,0,1402,60086,-9627,0.84
 2020,Matanuska-susitna,AK,"Matanuska-susitna, AK",52335,4,1398,59914,-7579,0.87
 2021,Matanuska-susitna,AK,"Matanuska-susitna, AK",54207,4,1853,79414,-25207,0.68
 2019,Mathews,VA,"Mathews, VA",59904,0,1448,62057,-2153,0.97
 2020,Mathews,VA,"Mathews, VA",62724,5,1615,69214,-6490,0.91
 2021,Mathews,VA,"Mathews, VA",66906,7,2026,86829,-19923,0.77
 2019,Maury,TN,"Maury, TN",45199,0,1433,61414,-16215,0.74
 2020,Maury,TN,"Maury, TN",48017,6,1398,59914,-11897,0.8
 2021,Maury,TN,"Maury, TN",52041,8,1928,82629,-30588,0.63
 2019,Maverick,TX,"Maverick, TX",32537,0,722,30943,1594,1.05
 2020,Maverick,TX,"Maverick, TX",35436,9,734,31457,3979,1.13
 2021,Maverick,TX,"Maverick, TX",38448,9,845,36214,2234,1.06
 2019,Mayes,OK,"Mayes, OK",38676,0,916,39257,-581,0.99
 2020,Mayes,OK,"Mayes, OK",41812,8,790,33857,7955,1.23
 2021,Mayes,OK,"Mayes, OK",44615,7,1261,54043,-9428,0.83
 2019,Mcclain,OK,"Mcclain, OK",49042,0,1200,51429,-2387,0.95
 2020,Mcclain,OK,"Mcclain, OK",50262,3,1173,50271,-9,1
 2021,Mcclain,OK,"Mcclain, OK",53330,6,1337,57300,-3970,0.93
 2019,Mccone,MT,"Mccone, MT",37815,0,1079,46243,-8428,0.82
 2020,Mccone,MT,"Mccone, MT",42057,11,1203,51557,-9500,0.82
 2021,Mccone,MT,"Mccone, MT",46848,11,1703,72986,-26138,0.64
 2019,Mccook,SD,"Mccook, SD",53326,0,691,29614,23712,1.8
 2020,Mccook,SD,"Mccook, SD",59210,11,733,31414,27796,1.88
 2021,Mccook,SD,"Mccook, SD",67402,14,875,37500,29902,1.8
 2019,Mccormick,SC,"Mccormick, SC",39739,0,1192,51086,-11347,0.78
 2020,Mccormick,SC,"Mccormick, SC",42206,6,1322,56657,-14451,0.74
 2021,Mccormick,SC,"Mccormick, SC",44391,5,1915,82071,-37680,0.54
 2019,Mccracken,KY,"Mccracken, KY",47619,0,789,33814,13805,1.41
 2020,Mccracken,KY,"Mccracken, KY",52296,10,938,40200,12096,1.3
 2021,Mccracken,KY,"Mccracken, KY",56089,7,916,39257,16832,1.43
 2019,Mccreary,KY,"Mccreary, KY",26951,0,414,17743,9208,1.52
 2020,Mccreary,KY,"Mccreary, KY",31370,16,433,18557,12813,1.69
 2021,Mccreary,KY,"Mccreary, KY",35811,14,679,29100,6711,1.23
 2019,Mcculloch,TX,"Mcculloch, TX",39901,0,671,28757,11144,1.39
 2020,Mcculloch,TX,"Mcculloch, TX",42301,6,622,26657,15644,1.59
 2021,Mcculloch,TX,"Mcculloch, TX",45744,8,559,23957,21787,1.91
 2019,Mccurtain,OK,"Mccurtain, OK",35030,0,1922,82371,-47341,0.43
 2020,Mccurtain,OK,"Mccurtain, OK",37605,7,2001,85757,-48152,0.44
 2021,Mccurtain,OK,"Mccurtain, OK",42574,13,2921,125186,-82612,0.34
 2019,Mcdonald,MO,"Mcdonald, MO",29020,0,857,36729,-7709,0.79
 2020,Mcdonald,MO,"Mcdonald, MO",31657,9,906,38829,-7172,0.82
 2021,Mcdonald,MO,"Mcdonald, MO",35275,11,1555,66643,-31368,0.53
 2019,Mcdonough,IL,"Mcdonough, IL",40509,0,413,17700,22809,2.29
 2020,Mcdonough,IL,"Mcdonough, IL",44477,10,398,17057,27420,2.61
 2021,Mcdonough,IL,"Mcdonough, IL",48261,9,315,13500,34761,3.57
 2019,Mcdowell,NC,"Mcdowell, NC",36377,0,1236,52971,-16594,0.69
 2020,Mcdowell,NC,"Mcdowell, NC",39398,8,1526,65400,-26002,0.6
 2021,Mcdowell,NC,"Mcdowell, NC",42960,9,1933,82843,-39883,0.52
 2019,Mcdowell,WV,"Mcdowell, WV",28919,0,240,10286,18633,2.81
 2020,Mcdowell,WV,"Mcdowell, WV",31221,8,242,10371,20850,3.01
 2021,Mcdowell,WV,"Mcdowell, WV",34141,9,222,9514,24627,3.59
 2019,Mcduffie,GA,"Mcduffie, GA",37325,0,958,41057,-3732,0.91
 2020,Mcduffie,GA,"Mcduffie, GA",40949,10,902,38657,2292,1.06
 2021,Mcduffie,GA,"Mcduffie, GA",43362,6,1097,47014,-3652,0.92
 2019,Mchenry,IL,"Mchenry, IL",56744,0,1329,56957,-213,1
 2020,Mchenry,IL,"Mchenry, IL",59737,5,1352,57943,1794,1.03
 2021,Mchenry,IL,"Mchenry, IL",64119,7,1435,61500,2619,1.04
 2019,Mchenry,ND,"Mchenry, ND",55062,0,526,22543,32519,2.44
 2020,Mchenry,ND,"Mchenry, ND",62880,14,566,24257,38623,2.59
 2021,Mchenry,ND,"Mchenry, ND",72140,15,679,29100,43040,2.48
 2019,Mcintosh,GA,"Mcintosh, GA",40536,0,1236,52971,-12435,0.77
 2020,Mcintosh,GA,"Mcintosh, GA",44683,10,1559,66814,-22131,0.67
 2021,Mcintosh,GA,"Mcintosh, GA",47287,6,1612,69086,-21799,0.68
 2019,Mcintosh,ND,"Mcintosh, ND",59208,0,395,16929,42279,3.5
 2020,Mcintosh,ND,"Mcintosh, ND",70439,19,397,17014,53425,4.14
 2021,Mcintosh,ND,"Mcintosh, ND",80675,15,333,14271,66404,5.65
 2019,Mcintosh,OK,"Mcintosh, OK",37404,0,797,34157,3247,1.1
 2020,Mcintosh,OK,"Mcintosh, OK",40174,7,864,37029,3145,1.08
 2021,Mcintosh,OK,"Mcintosh, OK",42241,5,1210,51857,-9616,0.81
 2019,Mckean,PA,"Mckean, PA",45010,0,383,16414,28596,2.74
 2020,Mckean,PA,"Mckean, PA",48118,7,395,16929,31189,2.84
 2021,Mckean,PA,"Mckean, PA",51169,6,607,26014,25155,1.97
 2019,Mckenzie,ND,"Mckenzie, ND",70441,0,1477,63300,7141,1.11
 2020,Mckenzie,ND,"Mckenzie, ND",66159,-6,1765,75643,-9484,0.87
 2021,Mckenzie,ND,"Mckenzie, ND",72258,9,1323,56700,15558,1.27
 2019,Mckinley,NM,"Mckinley, NM",28158,0,648,27771,387,1.01
 2020,Mckinley,NM,"Mckinley, NM",31889,13,807,34586,-2697,0.92
 2021,Mckinley,NM,"Mckinley, NM",34939,10,897,38443,-3504,0.91
 2019,Mclean,IL,"Mclean, IL",50152,0,789,33814,16338,1.48
 2020,Mclean,IL,"Mclean, IL",55203,10,763,32700,22503,1.69
 2021,Mclean,IL,"Mclean, IL",58503,6,715,30643,27860,1.91
 2019,Mclean,KY,"Mclean, KY",39711,0,559,23957,15754,1.66
 2020,Mclean,KY,"Mclean, KY",41707,5,638,27343,14364,1.53
 2021,Mclean,KY,"Mclean, KY",50679,22,708,30343,20336,1.67
 2019,Mclean,ND,"Mclean, ND",59239,0,794,34029,25210,1.74
 2020,Mclean,ND,"Mclean, ND",64151,8,797,34157,29994,1.88
 2021,Mclean,ND,"Mclean, ND",76889,20,1323,56700,20189,1.36
 2019,Mclennan,TX,"Mclennan, TX",42601,0,1065,45643,-3042,0.93
 2020,Mclennan,TX,"Mclennan, TX",45808,8,1091,46757,-949,0.98
 2021,Mclennan,TX,"Mclennan, TX",49512,8,1441,61757,-12245,0.8
 2019,Mcleod,MN,"Mcleod, MN",48098,0,956,40971,7127,1.17
 2020,Mcleod,MN,"Mcleod, MN",52942,10,1142,48943,3999,1.08
 2021,Mcleod,MN,"Mcleod, MN",56689,7,1250,53571,3118,1.06
 2019,Mcminn,TN,"Mcminn, TN",37942,0,794,34029,3913,1.11
 2020,Mcminn,TN,"Mcminn, TN",40753,7,823,35271,5482,1.16
 2021,Mcminn,TN,"Mcminn, TN",43715,7,1196,51257,-7542,0.85
 2019,Mcmullen,TX,"Mcmullen, TX",94047,0,719,30814,63233,3.05
 2020,Mcmullen,TX,"Mcmullen, TX",89304,-5,695,29786,59518,3
 2021,Mcmullen,TX,"Mcmullen, TX",110273,24,766,32829,77444,3.36
 2019,Mcnairy,TN,"Mcnairy, TN",33591,0,589,25243,8348,1.33
 2020,Mcnairy,TN,"Mcnairy, TN",35878,7,700,30000,5878,1.2
 2021,Mcnairy,TN,"Mcnairy, TN",38354,7,964,41314,-2960,0.93
 2019,Mcpherson,KS,"Mcpherson, KS",52871,0,760,32571,20300,1.62
 2020,Mcpherson,KS,"Mcpherson, KS",55947,6,812,34800,21147,1.61
 2021,Mcpherson,KS,"Mcpherson, KS",57951,4,694,29743,28208,1.95
 2021,Mcpherson,NE,"Mcpherson, NE",63343,-7,335,14357,48986,4.41
 2019,Mcpherson,SD,"Mcpherson, SD",41577,0,704,30171,11406,1.38
 2020,Mcpherson,SD,"Mcpherson, SD",55802,34,163,6986,48816,7.99
 2021,Mcpherson,SD,"Mcpherson, SD",65047,17,1037,44443,20604,1.46
 2019,Meade,KS,"Meade, KS",59202,0,529,22671,36531,2.61
 2020,Meade,KS,"Meade, KS",67486,14,474,20314,47172,3.32
 2021,Meade,KS,"Meade, KS",74713,11,542,23229,51484,3.22
 2019,Meade,KY,"Meade, KY",39859,0,894,38314,1545,1.04
 2020,Meade,KY,"Meade, KY",43040,8,1004,43029,11,1
 2021,Meade,KY,"Meade, KY",46893,9,1405,60214,-13321,0.78
 2019,Meade,SD,"Meade, SD",43775,0,1220,52286,-8511,0.84
 2020,Meade,SD,"Meade, SD",47918,10,1594,68314,-20396,0.7
 2021,Meade,SD,"Meade, SD",50972,6,2156,92400,-41428,0.55
 2019,Meagher,MT,"Meagher, MT",44049,0,1368,58629,-14580,0.75
 2020,Meagher,MT,"Meagher, MT",46482,6,1121,48043,-1561,0.97
 2021,Meagher,MT,"Meagher, MT",46835,1,2192,93943,-47108,0.5
 2019,Mecklenburg,NC,"Mecklenburg, NC",63805,0,1748,74914,-11109,0.85
 2020,Mecklenburg,NC,"Mecklenburg, NC",66863,5,1819,77957,-11094,0.86
 2021,Mecklenburg,NC,"Mecklenburg, NC",71836,7,2108,90343,-18507,0.8
 2019,Mecklenburg,VA,"Mecklenburg, VA",37981,0,926,39686,-1705,0.96
 2020,Mecklenburg,VA,"Mecklenburg, VA",41430,9,1009,43243,-1813,0.96
 2021,Mecklenburg,VA,"Mecklenburg, VA",46019,11,1277,54729,-8710,0.84
 2019,Mecosta,MI,"Mecosta, MI",37154,0,768,32914,4240,1.13
 2020,Mecosta,MI,"Mecosta, MI",41440,12,925,39643,1797,1.05
 2021,Mecosta,MI,"Mecosta, MI",44177,7,991,42471,1706,1.04
 2019,Medina,OH,"Medina, OH",58080,0,1381,59186,-1106,0.98
 2020,Medina,OH,"Medina, OH",60816,5,1403,60129,687,1.01
 2021,Medina,OH,"Medina, OH",64371,6,1623,69557,-5186,0.93
 2019,Medina,TX,"Medina, TX",44514,0,1409,60386,-15872,0.74
 2020,Medina,TX,"Medina, TX",46766,5,1466,62829,-16063,0.74
 2021,Medina,TX,"Medina, TX",50076,7,1881,80614,-30538,0.62
 2019,Meeker,MN,"Meeker, MN",45003,0,997,42729,2274,1.05
 2020,Meeker,MN,"Meeker, MN",49515,10,949,40671,8844,1.22
 2021,Meeker,MN,"Meeker, MN",53728,9,1200,51429,2299,1.04
 2019,Meigs,OH,"Meigs, OH",36845,0,647,27729,9116,1.33
 2020,Meigs,OH,"Meigs, OH",40789,11,451,19329,21460,2.11
 2021,Meigs,OH,"Meigs, OH",43469,7,798,34200,9269,1.27
 2019,Meigs,TN,"Meigs, TN",34639,0,1510,64714,-30075,0.54
 2020,Meigs,TN,"Meigs, TN",37645,9,1551,66471,-28826,0.57
 2021,Meigs,TN,"Meigs, TN",39452,5,2237,95871,-56419,0.41
 2020,Mellette,SD,"Mellette, SD",35580,15,263,11271,24309,3.16
 2021,Mellette,SD,"Mellette, SD",43805,23,367,15729,28076,2.78
 2019,Menard,IL,"Menard, IL",46275,0,720,30857,15418,1.5
 2020,Menard,IL,"Menard, IL",50478,9,829,35529,14949,1.42
 2021,Menard,IL,"Menard, IL",55848,11,764,32743,23105,1.71
 2019,Menard,TX,"Menard, TX",41428,0,1835,78643,-37215,0.53
 2020,Menard,TX,"Menard, TX",44122,7,462,19800,24322,2.23
 2021,Menard,TX,"Menard, TX",47390,7,2859,122529,-75139,0.39
 2019,Mendocino,CA,"Mendocino, CA",48013,0,2821,120900,-72887,0.4
 2020,Mendocino,CA,"Mendocino, CA",53087,11,2950,126429,-73342,0.42
 2021,Mendocino,CA,"Mendocino, CA",56047,6,3621,155186,-99139,0.36
 2019,Menifee,KY,"Menifee, KY",33644,0,404,17314,16330,1.94
 2020,Menifee,KY,"Menifee, KY",37592,12,475,20357,17235,1.85
 2021,Menifee,KY,"Menifee, KY",41028,9,650,27857,13171,1.47
 2019,Menominee,MI,"Menominee, MI",41962,0,669,28671,13291,1.46
 2020,Menominee,MI,"Menominee, MI",45802,9,668,28629,17173,1.6
 2021,Menominee,MI,"Menominee, MI",48873,7,704,30171,18702,1.62
 2019,Menominee,WI,"Menominee, WI",36500,0,1733,74271,-37771,0.49
 2020,Menominee,WI,"Menominee, WI",39554,8,1365,58500,-18946,0.68
 2021,Menominee,WI,"Menominee, WI",43212,9,2378,101914,-58702,0.42
 2019,Merced,CA,"Merced, CA",38626,0,1465,62786,-24160,0.62
 2020,Merced,CA,"Merced, CA",43980,14,1574,67457,-23477,0.65
 2021,Merced,CA,"Merced, CA",46580,6,2026,86829,-40249,0.54
 2019,Mercer,IL,"Mercer, IL",45401,0,443,18986,26415,2.39
 2020,Mercer,IL,"Mercer, IL",51623,14,485,20786,30837,2.48
 2021,Mercer,IL,"Mercer, IL",57676,12,449,19243,38433,3
 2019,Mercer,KY,"Mercer, KY",37023,0,958,41057,-4034,0.9
 2020,Mercer,KY,"Mercer, KY",39945,8,995,42643,-2698,0.94
 2021,Mercer,KY,"Mercer, KY",43163,8,1002,42943,220,1.01
 2019,Mercer,MO,"Mercer, MO",32105,0,658,28200,3905,1.14
 2020,Mercer,MO,"Mercer, MO",35568,11,362,15514,20054,2.29
 2021,Mercer,MO,"Mercer, MO",37104,4,602,25800,11304,1.44
 2019,Mercer,ND,"Mercer, ND",58481,0,785,33643,24838,1.74
 2020,Mercer,ND,"Mercer, ND",60817,4,729,31243,29574,1.95
 2021,Mercer,ND,"Mercer, ND",65113,7,707,30300,34813,2.15
 2019,Mercer,NJ,"Mercer, NJ",68721,0,1367,58586,10135,1.17
 2020,Mercer,NJ,"Mercer, NJ",71990,5,1646,70543,1447,1.02
 2021,Mercer,NJ,"Mercer, NJ",77911,8,1532,65657,12254,1.19
 2019,Mercer,OH,"Mercer, OH",50173,0,694,29743,20430,1.69
 2020,Mercer,OH,"Mercer, OH",54089,8,792,33943,20146,1.59
 2021,Mercer,OH,"Mercer, OH",59089,9,891,38186,20903,1.55
 2019,Mercer,PA,"Mercer, PA",42598,0,623,26700,15898,1.6
 2020,Mercer,PA,"Mercer, PA",46310,9,649,27814,18496,1.66
 2021,Mercer,PA,"Mercer, PA",49311,7,715,30643,18668,1.61
 2019,Mercer,WV,"Mercer, WV",38251,0,647,27729,10522,1.38
 2020,Mercer,WV,"Mercer, WV",41102,8,594,25457,15645,1.61
 2021,Mercer,WV,"Mercer, WV",44564,8,696,29829,14735,1.49
 2019,Meriwether,GA,"Meriwether, GA",37093,0,738,31629,5464,1.17
 2020,Meriwether,GA,"Meriwether, GA",40855,10,630,27000,13855,1.51
 2021,Meriwether,GA,"Meriwether, GA",44305,8,1083,46414,-2109,0.95
 2019,Merrick,NE,"Merrick, NE",48814,0,836,35829,12985,1.36
 2020,Merrick,NE,"Merrick, NE",52538,8,765,32786,19752,1.6
 2021,Merrick,NE,"Merrick, NE",56823,8,747,32014,24809,1.77
 2019,Merrimack,NH,"Merrimack, NH",60412,0,1489,63814,-3402,0.95
 2020,Merrimack,NH,"Merrimack, NH",64478,7,1564,67029,-2551,0.96
 2021,Merrimack,NH,"Merrimack, NH",68222,6,1983,84986,-16764,0.8
 2019,Mesa,CO,"Mesa, CO",46318,0,1565,67071,-20753,0.69
 2020,Mesa,CO,"Mesa, CO",48884,6,1810,77571,-28687,0.63
 2021,Mesa,CO,"Mesa, CO",52121,7,2095,89786,-37665,0.58
 2019,Metcalfe,KY,"Metcalfe, KY",31241,0,468,20057,11184,1.56
 2020,Metcalfe,KY,"Metcalfe, KY",34628,11,570,24429,10199,1.42
 2021,Metcalfe,KY,"Metcalfe, KY",38284,11,823,35271,3013,1.09
 2019,Miami-dade,FL,"Miami-dade, FL",56137,0,2170,93000,-36863,0.6
 2020,Miami-dade,FL,"Miami-dade, FL",57713,3,2269,97243,-39530,0.59
 2021,Miami-dade,FL,"Miami-dade, FL",64849,12,2636,112971,-48122,0.57
 2019,Miami,IN,"Miami, IN",34864,0,397,17014,17850,2.05
 2020,Miami,IN,"Miami, IN",37084,6,419,17957,19127,2.07
 2021,Miami,IN,"Miami, IN",40179,8,511,21900,18279,1.83
 2019,Miami,KS,"Miami, KS",50184,0,1027,44014,6170,1.14
 2020,Miami,KS,"Miami, KS",53526,7,1185,50786,2740,1.05
 2021,Miami,KS,"Miami, KS",56719,6,1475,63214,-6495,0.9
 2019,Miami,OH,"Miami, OH",48319,0,885,37929,10390,1.27
 2020,Miami,OH,"Miami, OH",51963,8,1231,52757,-794,0.98
 2021,Miami,OH,"Miami, OH",54947,6,1195,51214,3733,1.07
 2019,Middlesex,CT,"Middlesex, CT",68546,0,1713,73414,-4868,0.93
 2020,Middlesex,CT,"Middlesex, CT",71602,5,1806,77400,-5798,0.93
 2021,Middlesex,CT,"Middlesex, CT",74453,4,2214,94886,-20433,0.78
 2019,Middlesex,MA,"Middlesex, MA",87174,0,3034,130029,-42855,0.67
 2020,Middlesex,MA,"Middlesex, MA",92013,6,3335,142929,-50916,0.64
 2021,Middlesex,MA,"Middlesex, MA",98523,7,3461,148329,-49806,0.66
 2019,Middlesex,NJ,"Middlesex, NJ",61440,0,1682,72086,-10646,0.85
 2020,Middlesex,NJ,"Middlesex, NJ",64920,6,1806,77400,-12480,0.84
 2021,Middlesex,NJ,"Middlesex, NJ",70221,8,1943,83271,-13050,0.84
 2019,Middlesex,VA,"Middlesex, VA",53640,0,1412,60514,-6874,0.89
 2020,Middlesex,VA,"Middlesex, VA",56167,5,1623,69557,-13390,0.81
 2021,Middlesex,VA,"Middlesex, VA",59146,5,2071,88757,-29611,0.67
 2019,Mifflin,PA,"Mifflin, PA",40116,0,499,21386,18730,1.88
 2020,Mifflin,PA,"Mifflin, PA",44040,10,484,20743,23297,2.12
 2021,Mifflin,PA,"Mifflin, PA",46768,6,651,27900,18868,1.68
 2019,Milam,TX,"Milam, TX",38124,0,938,40200,-2076,0.95
 2020,Milam,TX,"Milam, TX",41208,8,952,40800,408,1.01
 2021,Milam,TX,"Milam, TX",45286,10,1492,63943,-18657,0.71
 2019,Millard,UT,"Millard, UT",38283,0,1010,43286,-5003,0.88
 2020,Millard,UT,"Millard, UT",40959,7,1008,43200,-2241,0.95
 2021,Millard,UT,"Millard, UT",44281,8,969,41529,2752,1.07
 2019,Mille Lacs,MN,"Mille Lacs, MN",43509,0,1186,50829,-7320,0.86
 2020,Mille Lacs,MN,"Mille Lacs, MN",47312,9,1096,46971,341,1.01
 2021,Mille Lacs,MN,"Mille Lacs, MN",50104,6,1526,65400,-15296,0.77
 2019,Miller,AR,"Miller, AR",35023,0,791,33900,1123,1.03
 2020,Miller,AR,"Miller, AR",37832,8,813,34843,2989,1.09
 2021,Miller,AR,"Miller, AR",40319,7,796,34114,6205,1.18
 2019,Miller,GA,"Miller, GA",43901,0,576,24686,19215,1.78
 2020,Miller,GA,"Miller, GA",46907,7,700,30000,16907,1.56
 2021,Miller,GA,"Miller, GA",50213,7,1001,42900,7313,1.17
 2019,Miller,MO,"Miller, MO",37824,0,995,42643,-4819,0.89
 2020,Miller,MO,"Miller, MO",41385,9,1102,47229,-5844,0.88
 2021,Miller,MO,"Miller, MO",43510,5,1822,78086,-34576,0.56
 2019,Mills,IA,"Mills, IA",59887,0,743,31843,28044,1.88
 2020,Mills,IA,"Mills, IA",61481,3,1223,52414,9067,1.17
 2021,Mills,IA,"Mills, IA",66042,7,1041,44614,21428,1.48
 2019,Mills,TX,"Mills, TX",43994,0,839,35957,8037,1.22
 2020,Mills,TX,"Mills, TX",49340,12,949,40671,8669,1.21
 2021,Mills,TX,"Mills, TX",51712,5,1775,76071,-24359,0.68
 2019,Milwaukee,WI,"Milwaukee, WI",48239,0,769,32957,15282,1.46
 2020,Milwaukee,WI,"Milwaukee, WI",51567,7,819,35100,16467,1.47
 2021,Milwaukee,WI,"Milwaukee, WI",55927,9,941,40329,15598,1.39
 2019,Miner,SD,"Miner, SD",47793,0,194,8314,39479,5.75
 2020,Miner,SD,"Miner, SD",58389,22,942,40371,18018,1.45
 2021,Miner,SD,"Miner, SD",65438,12,802,34371,31067,1.9
 2019,Mineral,CO,"Mineral, CO",66224,0,2061,88329,-22105,0.75
 2020,Mineral,CO,"Mineral, CO",67967,3,2487,106586,-38619,0.64
 2021,Mineral,CO,"Mineral, CO",70250,3,1591,68186,2064,1.03
 2019,Mineral,MT,"Mineral, MT",40374,0,1627,69729,-29355,0.58
 2020,Mineral,MT,"Mineral, MT",44492,10,1347,57729,-13237,0.77
 2021,Mineral,MT,"Mineral, MT",45966,3,3771,161614,-115648,0.28
 2019,Mineral,NV,"Mineral, NV",41053,0,629,26957,14096,1.52
 2020,Mineral,NV,"Mineral, NV",47029,15,624,26743,20286,1.76
 2021,Mineral,NV,"Mineral, NV",48836,4,672,28800,20036,1.7
 2019,Mineral,WV,"Mineral, WV",42607,0,772,33086,9521,1.29
 2020,Mineral,WV,"Mineral, WV",45398,7,679,29100,16298,1.56
 2021,Mineral,WV,"Mineral, WV",48155,6,757,32443,15712,1.48
 2019,Mingo,WV,"Mingo, WV",33117,0,395,16929,16188,1.96
 2020,Mingo,WV,"Mingo, WV",34489,4,407,17443,17046,1.98
 2021,Mingo,WV,"Mingo, WV",37396,8,516,22114,15282,1.69
 2019,Minidoka,ID,"Minidoka, ID",39944,0,919,39386,558,1.01
 2020,Minidoka,ID,"Minidoka, ID",43848,10,1107,47443,-3595,0.92
 2021,Minidoka,ID,"Minidoka, ID",45273,3,1680,72000,-26727,0.63
 2019,Minnehaha,SD,"Minnehaha, SD",62031,0,1086,46543,15488,1.33
 2020,Minnehaha,SD,"Minnehaha, SD",66044,7,1135,48643,17401,1.36
 2021,Minnehaha,SD,"Minnehaha, SD",69693,6,1308,56057,13636,1.24
 2019,Missaukee,MI,"Missaukee, MI",36752,0,685,29357,7395,1.25
 2020,Missaukee,MI,"Missaukee, MI",41488,13,912,39086,2402,1.06
 2021,Missaukee,MI,"Missaukee, MI",43609,5,1125,48214,-4605,0.9
 2019,Mississippi,AR,"Mississippi, AR",35086,0,478,20486,14600,1.71
 2020,Mississippi,AR,"Mississippi, AR",38264,9,399,17100,21164,2.24
 2021,Mississippi,AR,"Mississippi, AR",42273,11,461,19757,22516,2.14
 2019,Mississippi,MO,"Mississippi, MO",31911,0,519,22243,9668,1.43
 2020,Mississippi,MO,"Mississippi, MO",36534,15,393,16843,19691,2.17
 2021,Mississippi,MO,"Mississippi, MO",39424,8,503,21557,17867,1.83
 2019,Missoula,MT,"Missoula, MT",53992,0,1860,79714,-25722,0.68
 2020,Missoula,MT,"Missoula, MT",57895,7,2076,88971,-31076,0.65
 2021,Missoula,MT,"Missoula, MT",61881,7,3363,144129,-82248,0.43
 2019,Mitchell,GA,"Mitchell, GA",36055,0,493,21129,14926,1.71
 2020,Mitchell,GA,"Mitchell, GA",39267,9,571,24471,14796,1.6
 2021,Mitchell,GA,"Mitchell, GA",42397,8,673,28843,13554,1.47
 2019,Mitchell,IA,"Mitchell, IA",63627,0,547,23443,40184,2.71
 2020,Mitchell,IA,"Mitchell, IA",58720,-8,470,20143,38577,2.92
 2021,Mitchell,IA,"Mitchell, IA",63605,8,1054,45171,18434,1.41
 2019,Mitchell,KS,"Mitchell, KS",61496,0,475,20357,41139,3.02
 2020,Mitchell,KS,"Mitchell, KS",70316,14,1029,44100,26216,1.59
 2021,Mitchell,KS,"Mitchell, KS",71245,1,503,21557,49688,3.3
 2019,Mitchell,NC,"Mitchell, NC",37938,0,1092,46800,-8862,0.81
 2020,Mitchell,NC,"Mitchell, NC",40735,7,1255,53786,-13051,0.76
 2021,Mitchell,NC,"Mitchell, NC",43973,8,1470,63000,-19027,0.7
 2019,Mitchell,TX,"Mitchell, TX",33045,0,401,17186,15859,1.92
 2020,Mitchell,TX,"Mitchell, TX",33486,1,382,16371,17115,2.05
 2021,Mitchell,TX,"Mitchell, TX",35417,6,446,19114,16303,1.85
 2019,Mobile,AL,"Mobile, AL",39453,0,776,33257,6196,1.19
 2020,Mobile,AL,"Mobile, AL",42837,9,872,37371,5466,1.15
 2021,Mobile,AL,"Mobile, AL",46418,8,953,40843,5575,1.14
 2019,Modoc,CA,"Modoc, CA",46245,0,840,36000,10245,1.28
 2020,Modoc,CA,"Modoc, CA",52459,13,805,34500,17959,1.52
 2021,Modoc,CA,"Modoc, CA",54301,4,1261,54043,258,1
 2019,Moffat,CO,"Moffat, CO",41744,0,786,33686,8058,1.24
 2020,Moffat,CO,"Moffat, CO",45652,9,1026,43971,1681,1.04
 2021,Moffat,CO,"Moffat, CO",49227,8,1202,51514,-2287,0.96
 2019,Mohave,AZ,"Mohave, AZ",35647,0,1381,59186,-23539,0.6
 2020,Mohave,AZ,"Mohave, AZ",38717,9,1559,66814,-28097,0.58
 2021,Mohave,AZ,"Mohave, AZ",41331,7,1642,70371,-29040,0.59
 2019,Moniteau,MO,"Moniteau, MO",38417,0,494,21171,17246,1.81
 2020,Moniteau,MO,"Moniteau, MO",43446,13,650,27857,15589,1.56
 2021,Moniteau,MO,"Moniteau, MO",46530,7,783,33557,12973,1.39
 2019,Monmouth,NJ,"Monmouth, NJ",82513,0,2484,106457,-23944,0.78
 2020,Monmouth,NJ,"Monmouth, NJ",86029,4,2648,113486,-27457,0.76
 2021,Monmouth,NJ,"Monmouth, NJ",92119,7,2920,125143,-33024,0.74
 2019,Mono,CA,"Mono, CA",55369,0,2575,110357,-54988,0.5
 2020,Mono,CA,"Mono, CA",61649,11,3045,130500,-68851,0.47
 2021,Mono,CA,"Mono, CA",64164,4,4190,179571,-115407,0.36
 2019,Monona,IA,"Monona, IA",46043,0,559,23957,22086,1.92
 2020,Monona,IA,"Monona, IA",49494,8,672,28800,20694,1.72
 2021,Monona,IA,"Monona, IA",57720,17,652,27943,29777,2.07
 2019,Monongalia,WV,"Monongalia, WV",48091,0,1277,54729,-6638,0.88
 2020,Monongalia,WV,"Monongalia, WV",49890,4,1413,60557,-10667,0.82
 2021,Monongalia,WV,"Monongalia, WV",52576,5,1407,60300,-7724,0.87
 2019,Monroe,AL,"Monroe, AL",35416,0,649,27814,7602,1.27
 2020,Monroe,AL,"Monroe, AL",39339,11,628,26914,12425,1.46
 2021,Monroe,AL,"Monroe, AL",42872,9,871,37329,5543,1.15
 2019,Monroe,AR,"Monroe, AR",33835,0,533,22843,10992,1.48
 2020,Monroe,AR,"Monroe, AR",40187,19,357,15300,24887,2.63
 2021,Monroe,AR,"Monroe, AR",41783,4,586,25114,16669,1.66
 2019,Monroe,FL,"Monroe, FL",98415,0,3496,149829,-51414,0.66
 2020,Monroe,FL,"Monroe, FL",99764,1,3839,164529,-64765,0.61
 2021,Monroe,FL,"Monroe, FL",109136,9,5716,244971,-135835,0.45
 2019,Monroe,GA,"Monroe, GA",47038,0,1428,61200,-14162,0.77
 2020,Monroe,GA,"Monroe, GA",49781,6,1830,78429,-28648,0.63
 2021,Monroe,GA,"Monroe, GA",52718,6,1692,72514,-19796,0.73
 2019,Monroe,IA,"Monroe, IA",46202,0,441,18900,27302,2.44
 2020,Monroe,IA,"Monroe, IA",49319,7,711,30471,18848,1.62
 2021,Monroe,IA,"Monroe, IA",52821,7,652,27943,24878,1.89
 2019,Monroe,IL,"Monroe, IL",58859,0,1326,56829,2030,1.04
 2020,Monroe,IL,"Monroe, IL",61273,4,1337,57300,3973,1.07
 2021,Monroe,IL,"Monroe, IL",65224,6,1545,66214,-990,0.99
 2019,Monroe,IN,"Monroe, IN",46097,0,1348,57771,-11674,0.8
 2020,Monroe,IN,"Monroe, IN",48974,6,1591,68186,-19212,0.72
 2021,Monroe,IN,"Monroe, IN",52392,7,1741,74614,-22222,0.7
 2019,Monroe,KY,"Monroe, KY",35242,0,456,19543,15699,1.8
 2020,Monroe,KY,"Monroe, KY",39461,12,696,29829,9632,1.32
 2021,Monroe,KY,"Monroe, KY",44045,12,782,33514,10531,1.31
 2019,Monroe,MI,"Monroe, MI",47726,0,940,40286,7440,1.18
 2020,Monroe,MI,"Monroe, MI",50472,6,991,42471,8001,1.19
 2021,Monroe,MI,"Monroe, MI",53509,6,1145,49071,4438,1.09
 2019,Monroe,MO,"Monroe, MO",41106,0,518,22200,18906,1.85
 2020,Monroe,MO,"Monroe, MO",43467,6,490,21000,22467,2.07
 2021,Monroe,MO,"Monroe, MO",47215,9,835,35786,11429,1.32
 2019,Monroe,MS,"Monroe, MS",37602,0,486,20829,16773,1.81
 2020,Monroe,MS,"Monroe, MS",40976,9,667,28586,12390,1.43
 2021,Monroe,MS,"Monroe, MS",44332,8,638,27343,16989,1.62
 2019,Monroe,NY,"Monroe, NY",53057,0,939,40243,12814,1.32
 2020,Monroe,NY,"Monroe, NY",57252,8,1058,45343,11909,1.26
 2021,Monroe,NY,"Monroe, NY",60046,5,874,37457,22589,1.6
 2019,Monroe,OH,"Monroe, OH",38342,0,905,38786,-444,0.99
 2020,Monroe,OH,"Monroe, OH",42900,12,773,33129,9771,1.29
 2021,Monroe,OH,"Monroe, OH",43844,2,663,28414,15430,1.54
 2019,Monroe,PA,"Monroe, PA",45196,0,847,36300,8896,1.25
 2020,Monroe,PA,"Monroe, PA",49469,10,913,39129,10340,1.26
 2021,Monroe,PA,"Monroe, PA",53118,7,1429,61243,-8125,0.87
 2019,Monroe,TN,"Monroe, TN",36325,0,1064,45600,-9275,0.8
 2020,Monroe,TN,"Monroe, TN",39204,8,1187,50871,-11667,0.77
 2021,Monroe,TN,"Monroe, TN",42276,8,1424,61029,-18753,0.69
 2019,Monroe,WI,"Monroe, WI",42543,0,877,37586,4957,1.13
 2020,Monroe,WI,"Monroe, WI",46451,9,1010,43286,3165,1.07
 2021,Monroe,WI,"Monroe, WI",49000,6,1323,56700,-7700,0.86
 2019,Monroe,WV,"Monroe, WV",35289,0,744,31886,3403,1.11
 2020,Monroe,WV,"Monroe, WV",38094,8,807,34586,3508,1.1
 2021,Monroe,WV,"Monroe, WV",41207,8,706,30257,10950,1.36
 2019,Montague,TX,"Montague, TX",42669,0,793,33986,8683,1.26
 2020,Montague,TX,"Montague, TX",43419,2,767,32871,10548,1.32
 2021,Montague,TX,"Montague, TX",45716,5,1099,47100,-1384,0.97
 2019,Montcalm,MI,"Montcalm, MI",34438,0,699,29957,4481,1.15
 2020,Montcalm,MI,"Montcalm, MI",38314,11,869,37243,1071,1.03
 2021,Montcalm,MI,"Montcalm, MI",40592,6,867,37157,3435,1.09
 2019,Monterey,CA,"Monterey, CA",56313,0,4317,185014,-128701,0.3
 2020,Monterey,CA,"Monterey, CA",61105,9,5255,225214,-164109,0.27
 2021,Monterey,CA,"Monterey, CA",63449,4,5120,219429,-155980,0.29
 2019,Montezuma,CO,"Montezuma, CO",44060,0,1592,68229,-24169,0.65
 2020,Montezuma,CO,"Montezuma, CO",46887,6,1826,78257,-31370,0.6
 2021,Montezuma,CO,"Montezuma, CO",50960,9,2345,100500,-49540,0.51
 2019,Montgomery,AL,"Montgomery, AL",43593,0,861,36900,6693,1.18
 2020,Montgomery,AL,"Montgomery, AL",47054,8,1055,45214,1840,1.04
 2021,Montgomery,AL,"Montgomery, AL",50337,7,995,42643,7694,1.18
 2019,Montgomery,AR,"Montgomery, AR",31575,0,879,37671,-6096,0.84
 2020,Montgomery,AR,"Montgomery, AR",34374,9,1048,44914,-10540,0.77
 2021,Montgomery,AR,"Montgomery, AR",37039,8,1417,60729,-23690,0.61
 2019,Montgomery,GA,"Montgomery, GA",31503,0,977,41871,-10368,0.75
 2020,Montgomery,GA,"Montgomery, GA",35598,13,969,41529,-5931,0.86
 2021,Montgomery,GA,"Montgomery, GA",37935,7,1592,68229,-30294,0.56
 2019,Montgomery,IA,"Montgomery, IA",41310,0,539,23100,18210,1.79
 2020,Montgomery,IA,"Montgomery, IA",44375,7,397,17014,27361,2.61
 2021,Montgomery,IA,"Montgomery, IA",48436,9,395,16929,31507,2.86
 2019,Montgomery,IL,"Montgomery, IL",35749,0,373,15986,19763,2.24
 2020,Montgomery,IL,"Montgomery, IL",39594,11,461,19757,19837,2
 2021,Montgomery,IL,"Montgomery, IL",43358,10,491,21043,22315,2.06
 2019,Montgomery,IN,"Montgomery, IN",40969,0,577,24729,16240,1.66
 2020,Montgomery,IN,"Montgomery, IN",44618,9,682,29229,15389,1.53
 2021,Montgomery,IN,"Montgomery, IN",48866,10,883,37843,11023,1.29
 2019,Montgomery,KS,"Montgomery, KS",37622,0,282,12086,25536,3.11
 2020,Montgomery,KS,"Montgomery, KS",40841,9,357,15300,25541,2.67
 2021,Montgomery,KS,"Montgomery, KS",43689,7,348,14914,28775,2.93
 2019,Montgomery,KY,"Montgomery, KY",36140,0,818,35057,1083,1.03
 2020,Montgomery,KY,"Montgomery, KY",39770,10,820,35143,4627,1.13
 2021,Montgomery,KY,"Montgomery, KY",42710,7,1205,51643,-8933,0.83
 2019,Montgomery,MD,"Montgomery, MD",86039,0,2560,109714,-23675,0.78
 2020,Montgomery,MD,"Montgomery, MD",87507,2,2681,114900,-27393,0.76
 2021,Montgomery,MD,"Montgomery, MD",92740,6,2354,100886,-8146,0.92
 2019,Montgomery,MO,"Montgomery, MO",41856,0,544,23314,18542,1.8
 2020,Montgomery,MO,"Montgomery, MO",46685,12,673,28843,17842,1.62
 2021,Montgomery,MO,"Montgomery, MO",49923,7,706,30257,19666,1.65
 2019,Montgomery,MS,"Montgomery, MS",35009,0,509,21814,13195,1.6
 2020,Montgomery,MS,"Montgomery, MS",38639,10,545,23357,15282,1.65
 2021,Montgomery,MS,"Montgomery, MS",41252,7,623,26700,14552,1.55
 2019,Montgomery,NC,"Montgomery, NC",38850,0,1149,49243,-10393,0.79
 2020,Montgomery,NC,"Montgomery, NC",42133,9,1203,51557,-9424,0.82
 2021,Montgomery,NC,"Montgomery, NC",46916,11,955,40929,5987,1.15
 2019,Montgomery,NY,"Montgomery, NY",42045,0,594,25457,16588,1.65
 2020,Montgomery,NY,"Montgomery, NY",46018,9,603,25843,20175,1.78
 2021,Montgomery,NY,"Montgomery, NY",48821,6,922,39514,9307,1.24
 2019,Montgomery,OH,"Montgomery, OH",48011,0,575,24643,23368,1.95
 2020,Montgomery,OH,"Montgomery, OH",51883,8,603,25843,26040,2.01
 2021,Montgomery,OH,"Montgomery, OH",54822,6,620,26571,28251,2.06
 2019,Montgomery,PA,"Montgomery, PA",79267,0,1721,73757,5510,1.07
 2020,Montgomery,PA,"Montgomery, PA",84342,6,2007,86014,-1672,0.98
 2021,Montgomery,PA,"Montgomery, PA",88671,5,2021,86614,2057,1.02
 2019,Montgomery,TN,"Montgomery, TN",42647,0,1217,52157,-9510,0.82
 2020,Montgomery,TN,"Montgomery, TN",45493,7,1262,54086,-8593,0.84
 2021,Montgomery,TN,"Montgomery, TN",48104,6,1605,68786,-20682,0.7
 2019,Montgomery,TX,"Montgomery, TX",65882,0,1575,67500,-1618,0.98
 2020,Montgomery,TX,"Montgomery, TX",66440,1,1544,66171,269,1
 2021,Montgomery,TX,"Montgomery, TX",68974,4,1780,76286,-7312,0.9
 2019,Montmorency,MI,"Montmorency, MI",38520,0,591,25329,13191,1.52
 2020,Montmorency,MI,"Montmorency, MI",43272,12,516,22114,21158,1.96
 2021,Montmorency,MI,"Montmorency, MI",43331,0,803,34414,8917,1.26
 2019,Montour,PA,"Montour, PA",57124,0,1113,47700,9424,1.2
 2020,Montour,PA,"Montour, PA",60685,6,1438,61629,-944,0.98
 2021,Montour,PA,"Montour, PA",64548,6,1225,52500,12048,1.23
 2019,Montrose,CO,"Montrose, CO",43187,0,1536,65829,-22642,0.66
 2020,Montrose,CO,"Montrose, CO",46747,8,1712,73371,-26624,0.64
 2021,Montrose,CO,"Montrose, CO",50789,9,2442,104657,-53868,0.49
 2019,Moody,SD,"Moody, SD",52556,0,894,38314,14242,1.37
 2020,Moody,SD,"Moody, SD",61461,17,788,33771,27690,1.82
 2021,Moody,SD,"Moody, SD",65719,7,853,36557,29162,1.8
 2019,Moore,NC,"Moore, NC",54737,0,1499,64243,-9506,0.85
 2020,Moore,NC,"Moore, NC",57819,6,1618,69343,-11524,0.83
 2021,Moore,NC,"Moore, NC",60775,5,1899,81386,-20611,0.75
 2019,Moore,TN,"Moore, TN",43240,0,1519,65100,-21860,0.66
 2020,Moore,TN,"Moore, TN",45380,5,1625,69643,-24263,0.65
 2021,Moore,TN,"Moore, TN",48015,6,1584,67886,-19871,0.71
 2019,Moore,TX,"Moore, TX",46943,0,880,37714,9229,1.24
 2020,Moore,TX,"Moore, TX",50379,7,626,26829,23550,1.88
 2021,Moore,TX,"Moore, TX",56634,12,789,33814,22820,1.67
 2019,Mora,NM,"Mora, NM",43595,0,1384,59314,-15719,0.73
 2020,Mora,NM,"Mora, NM",48632,12,1335,57214,-8582,0.85
 2021,Mora,NM,"Mora, NM",51939,7,1940,83143,-31204,0.62
 2019,Morehouse,LA,"Morehouse, LA",37252,0,511,21900,15352,1.7
 2020,Morehouse,LA,"Morehouse, LA",41664,12,497,21300,20364,1.96
 2021,Morehouse,LA,"Morehouse, LA",44860,8,655,28071,16789,1.6
 2019,Morgan,AL,"Morgan, AL",40831,0,903,38700,2131,1.06
 2020,Morgan,AL,"Morgan, AL",44204,8,1051,45043,-839,0.98
 2021,Morgan,AL,"Morgan, AL",47479,7,1322,56657,-9178,0.84
 2019,Morgan,CO,"Morgan, CO",44756,0,1434,61457,-16701,0.73
 2020,Morgan,CO,"Morgan, CO",47366,6,1450,62143,-14777,0.76
 2021,Morgan,CO,"Morgan, CO",52069,10,1555,66643,-14574,0.78
 2019,Morgan,GA,"Morgan, GA",51582,0,1776,76114,-24532,0.68
 2020,Morgan,GA,"Morgan, GA",53835,4,1956,83829,-29994,0.64
 2021,Morgan,GA,"Morgan, GA",57857,8,2376,101829,-43972,0.57
 2019,Morgan,IL,"Morgan, IL",41094,0,578,24771,16323,1.66
 2020,Morgan,IL,"Morgan, IL",45084,10,532,22800,22284,1.98
 2021,Morgan,IL,"Morgan, IL",49678,10,504,21600,28078,2.3
 2019,Morgan,IN,"Morgan, IN",44963,0,1199,51386,-6423,0.88
 2020,Morgan,IN,"Morgan, IN",47662,6,1105,47357,305,1.01
 2021,Morgan,IN,"Morgan, IN",51539,8,1337,57300,-5761,0.9
 2019,Morgan,KY,"Morgan, KY",27348,0,637,27300,48,1
 2020,Morgan,KY,"Morgan, KY",30732,12,503,21557,9175,1.43
 2021,Morgan,KY,"Morgan, KY",33208,8,856,36686,-3478,0.91
 2019,Morgan,MO,"Morgan, MO",41617,0,989,42386,-769,0.98
 2020,Morgan,MO,"Morgan, MO",44776,8,923,39557,5219,1.13
 2021,Morgan,MO,"Morgan, MO",47637,6,1082,46371,1266,1.03
 2019,Morgan,OH,"Morgan, OH",35887,0,512,21943,13944,1.64
 2020,Morgan,OH,"Morgan, OH",40418,13,459,19671,20747,2.05
 2021,Morgan,OH,"Morgan, OH",43249,7,833,35700,7549,1.21
 2019,Morgan,TN,"Morgan, TN",32561,0,786,33686,-1125,0.97
 2020,Morgan,TN,"Morgan, TN",35188,8,877,37586,-2398,0.94
 2021,Morgan,TN,"Morgan, TN",39005,11,1533,65700,-26695,0.59
 2019,Morgan,UT,"Morgan, UT",54976,0,2401,102900,-47924,0.53
 2020,Morgan,UT,"Morgan, UT",58768,7,2908,124629,-65861,0.47
 2021,Morgan,UT,"Morgan, UT",63256,8,4335,185786,-122530,0.34
 2019,Morgan,WV,"Morgan, WV",38901,0,1021,43757,-4856,0.89
 2020,Morgan,WV,"Morgan, WV",41709,7,1014,43457,-1748,0.96
 2021,Morgan,WV,"Morgan, WV",44779,7,1262,54086,-9307,0.83
 2019,Morrill,NE,"Morrill, NE",57763,0,339,14529,43234,3.98
 2020,Morrill,NE,"Morrill, NE",63827,11,624,26743,37084,2.39
 2021,Morrill,NE,"Morrill, NE",65524,3,530,22714,42810,2.88
 2019,Morris,KS,"Morris, KS",45012,0,688,29486,15526,1.53
 2020,Morris,KS,"Morris, KS",51167,14,678,29057,22110,1.76
 2021,Morris,KS,"Morris, KS",52926,3,511,21900,31026,2.42
 2019,Morris,NJ,"Morris, NJ",97774,0,2424,103886,-6112,0.94
 2020,Morris,NJ,"Morris, NJ",100617,3,2584,110743,-10126,0.91
 2021,Morris,NJ,"Morris, NJ",107767,7,2651,113614,-5847,0.95
 2019,Morris,TX,"Morris, TX",41319,0,462,19800,21519,2.09
 2020,Morris,TX,"Morris, TX",44101,7,631,27043,17058,1.63
 2021,Morris,TX,"Morris, TX",47226,7,779,33386,13840,1.41
 2019,Morrison,MN,"Morrison, MN",41933,0,888,38057,3876,1.1
 2020,Morrison,MN,"Morrison, MN",47136,12,894,38314,8822,1.23
 2021,Morrison,MN,"Morrison, MN",50229,7,1063,45557,4672,1.1
 2019,Morrow,OH,"Morrow, OH",41694,0,1080,46286,-4592,0.9
 2020,Morrow,OH,"Morrow, OH",45968,10,903,38700,7268,1.19
 2021,Morrow,OH,"Morrow, OH",49162,7,1279,54814,-5652,0.9
 2019,Morrow,OR,"Morrow, OR",46189,0,852,36514,9675,1.26
 2020,Morrow,OR,"Morrow, OR",48990,6,1422,60943,-11953,0.8
 2021,Morrow,OR,"Morrow, OR",51670,6,1466,62829,-11159,0.82
 2019,Morton,KS,"Morton, KS",42126,0,269,11529,30597,3.65
 2020,Morton,KS,"Morton, KS",49035,16,281,12043,36992,4.07
 2021,Morton,KS,"Morton, KS",58423,19,433,18557,39866,3.15
 2019,Morton,ND,"Morton, ND",52389,0,1159,49671,2718,1.05
 2020,Morton,ND,"Morton, ND",55406,6,1167,50014,5392,1.11
 2021,Morton,ND,"Morton, ND",58630,6,1221,52329,6301,1.12
 2019,Motley,TX,"Motley, TX",36022,0,0,0,36022,0
 2020,Motley,TX,"Motley, TX",41872,16,237,10157,31715,4.12
 2019,Moultrie,IL,"Moultrie, IL",68254,0,455,19500,48754,3.5
 2020,Moultrie,IL,"Moultrie, IL",69993,3,516,22114,47879,3.17
 2021,Moultrie,IL,"Moultrie, IL",76100,9,474,20314,55786,3.75
 2019,Mountrail,ND,"Mountrail, ND",68215,0,861,36900,31315,1.85
 2020,Mountrail,ND,"Mountrail, ND",68259,0,837,35871,32388,1.9
 2021,Mountrail,ND,"Mountrail, ND",72419,6,1288,55200,17219,1.31
 2019,Mower,MN,"Mower, MN",46076,0,577,24729,21347,1.86
 2020,Mower,MN,"Mower, MN",50565,10,841,36043,14522,1.4
 2021,Mower,MN,"Mower, MN",55320,9,687,29443,25877,1.88
 2019,Muhlenberg,KY,"Muhlenberg, KY",34740,0,556,23829,10911,1.46
 2020,Muhlenberg,KY,"Muhlenberg, KY",37023,7,569,24386,12637,1.52
 2021,Muhlenberg,KY,"Muhlenberg, KY",40634,10,711,30471,10163,1.33
 2019,Multnomah,OR,"Multnomah, OR",59993,0,2286,97971,-37978,0.61
 2020,Multnomah,OR,"Multnomah, OR",64858,8,2232,95657,-30799,0.68
 2021,Multnomah,OR,"Multnomah, OR",70331,8,2456,105257,-34926,0.67
 2019,Murray,GA,"Murray, GA",31274,0,832,35657,-4383,0.88
 2020,Murray,GA,"Murray, GA",34039,9,861,36900,-2861,0.92
 2021,Murray,GA,"Murray, GA",37264,10,1021,43757,-6493,0.85
 2019,Murray,MN,"Murray, MN",52874,0,608,26057,26817,2.03
 2020,Murray,MN,"Murray, MN",62101,18,779,33386,28715,1.86
 2021,Murray,MN,"Murray, MN",63623,3,747,32014,31609,1.99
 2019,Murray,OK,"Murray, OK",43630,0,669,28671,14959,1.52
 2020,Murray,OK,"Murray, OK",45070,3,765,32786,12284,1.37
 2021,Murray,OK,"Murray, OK",48831,8,880,37714,11117,1.29
 2019,Muscatine,IA,"Muscatine, IA",48011,0,764,32743,15268,1.47
 2020,Muscatine,IA,"Muscatine, IA",50326,5,705,30214,20112,1.67
 2021,Muscatine,IA,"Muscatine, IA",53861,7,711,30471,23390,1.77
 2019,Muscogee,GA,"Muscogee, GA",42149,0,694,29743,12406,1.42
 2020,Muscogee,GA,"Muscogee, GA",45144,7,735,31500,13644,1.43
 2021,Muscogee,GA,"Muscogee, GA",49091,9,804,34457,14634,1.42
 2019,Muskegon,MI,"Muskegon, MI",39646,0,823,35271,4375,1.12
 2020,Muskegon,MI,"Muskegon, MI",44159,11,853,36557,7602,1.21
 2021,Muskegon,MI,"Muskegon, MI",46701,6,923,39557,7144,1.18
 2019,Muskingum,OH,"Muskingum, OH",42244,0,762,32657,9587,1.29
 2020,Muskingum,OH,"Muskingum, OH",46224,9,730,31286,14938,1.48
 2021,Muskingum,OH,"Muskingum, OH",49160,6,804,34457,14703,1.43
 2019,Muskogee,OK,"Muskogee, OK",38355,0,514,22029,16326,1.74
 2020,Muskogee,OK,"Muskogee, OK",40934,7,626,26829,14105,1.53
 2021,Muskogee,OK,"Muskogee, OK",43699,7,548,23486,20213,1.86
 2019,Musselshell,MT,"Musselshell, MT",44810,0,712,30514,14296,1.47
 2020,Musselshell,MT,"Musselshell, MT",48195,8,756,32400,15795,1.49
 2021,Musselshell,MT,"Musselshell, MT",49553,3,1879,80529,-30976,0.62
 2019,Nacogdoches,TX,"Nacogdoches, TX",39665,0,1021,43757,-4092,0.91
 2020,Nacogdoches,TX,"Nacogdoches, TX",42073,6,979,41957,116,1
 2021,Nacogdoches,TX,"Nacogdoches, TX",46246,10,1370,58714,-12468,0.79
 2019,Nance,NE,"Nance, NE",40694,0,484,20743,19951,1.96
 2020,Nance,NE,"Nance, NE",47317,16,588,25200,22117,1.88
 2021,Nance,NE,"Nance, NE",55096,16,942,40371,14725,1.36
 2019,Nantucket,MA,"Nantucket, MA",96986,0,10757,461014,-364028,0.21
 2020,Nantucket,MA,"Nantucket, MA",93793,-3,14349,614957,-521164,0.15
 2021,Nantucket,MA,"Nantucket, MA",101902,9,17814,763457,-661555,0.13
 2019,Napa,CA,"Napa, CA",74379,0,4141,177471,-103092,0.42
 2020,Napa,CA,"Napa, CA",82643,11,4887,209443,-126800,0.39
 2021,Napa,CA,"Napa, CA",90608,10,6526,279686,-189078,0.32
 2019,Nash,NC,"Nash, NC",44063,0,791,33900,10163,1.3
 2020,Nash,NC,"Nash, NC",46885,6,920,39429,7456,1.19
 2021,Nash,NC,"Nash, NC",50714,8,1297,55586,-4872,0.91
 2019,Nassau,FL,"Nassau, FL",63408,0,1777,76157,-12749,0.83
 2020,Nassau,FL,"Nassau, FL",66227,4,1866,79971,-13744,0.83
 2021,Nassau,FL,"Nassau, FL",70010,6,2439,104529,-34519,0.67
 2019,Nassau,NY,"Nassau, NY",89713,0,3029,129814,-40101,0.69
 2020,Nassau,NY,"Nassau, NY",93715,5,3194,136886,-43171,0.68
 2021,Nassau,NY,"Nassau, NY",99597,6,3436,147257,-47660,0.68
 2019,Natchitoches,LA,"Natchitoches, LA",41188,0,1034,44314,-3126,0.93
 2020,Natchitoches,LA,"Natchitoches, LA",43373,5,1074,46029,-2656,0.94
 2021,Natchitoches,LA,"Natchitoches, LA",46579,7,1251,53614,-7035,0.87
 2019,Natrona,WY,"Natrona, WY",69791,0,1164,49886,19905,1.4
 2020,Natrona,WY,"Natrona, WY",67229,-4,1145,49071,18158,1.37
 2021,Natrona,WY,"Natrona, WY",70175,4,1238,53057,17118,1.32
 2019,Navajo,AZ,"Navajo, AZ",33756,0,1367,58586,-24830,0.58
 2020,Navajo,AZ,"Navajo, AZ",38524,14,1378,59057,-20533,0.65
 2021,Navajo,AZ,"Navajo, AZ",41680,8,2161,92614,-50934,0.45
 2019,Navarro,TX,"Navarro, TX",39544,0,892,38229,1315,1.03
 2020,Navarro,TX,"Navarro, TX",41872,6,966,41400,472,1.01
 2021,Navarro,TX,"Navarro, TX",45616,9,1367,58586,-12970,0.78
 2019,Nelson,KY,"Nelson, KY",44046,0,934,40029,4017,1.1
 2020,Nelson,KY,"Nelson, KY",47852,9,853,36557,11295,1.31
 2021,Nelson,KY,"Nelson, KY",51367,7,1278,54771,-3404,0.94
 2019,Nelson,ND,"Nelson, ND",58823,0,591,25329,33494,2.32
 2020,Nelson,ND,"Nelson, ND",71728,22,441,18900,52828,3.8
 2021,Nelson,ND,"Nelson, ND",70971,-1,745,31929,39042,2.22
 2019,Nelson,VA,"Nelson, VA",54067,0,1278,54771,-704,0.99
 2020,Nelson,VA,"Nelson, VA",58929,9,1482,63514,-4585,0.93
 2021,Nelson,VA,"Nelson, VA",63085,7,2259,96814,-33729,0.65
 2019,Nemaha,KS,"Nemaha, KS",50709,0,424,18171,32538,2.79
 2020,Nemaha,KS,"Nemaha, KS",57969,14,856,36686,21283,1.58
 2021,Nemaha,KS,"Nemaha, KS",60858,5,347,14871,45987,4.09
 2019,Nemaha,NE,"Nemaha, NE",48317,0,502,21514,26803,2.25
 2020,Nemaha,NE,"Nemaha, NE",51393,6,544,23314,28079,2.2
 2021,Nemaha,NE,"Nemaha, NE",56823,11,624,26743,30080,2.12
 2019,Neosho,KS,"Neosho, KS",40964,0,381,16329,24635,2.51
 2020,Neosho,KS,"Neosho, KS",44751,9,418,17914,26837,2.5
 2021,Neosho,KS,"Neosho, KS",47902,7,484,20743,27159,2.31
 2019,Neshoba,MS,"Neshoba, MS",37989,0,618,26486,11503,1.43
 2020,Neshoba,MS,"Neshoba, MS",39519,4,647,27729,11790,1.43
 2021,Neshoba,MS,"Neshoba, MS",43915,11,654,28029,15886,1.57
 2019,Ness,KS,"Ness, KS",54381,0,412,17657,36724,3.08
 2020,Ness,KS,"Ness, KS",60791,12,334,14314,46477,4.25
 2021,Ness,KS,"Ness, KS",66087,9,908,38914,27173,1.7
 2019,Nevada,AR,"Nevada, AR",33332,0,339,14529,18803,2.29
 2020,Nevada,AR,"Nevada, AR",35106,5,337,14443,20663,2.43
 2021,Nevada,AR,"Nevada, AR",39041,11,711,30471,8570,1.28
 2019,Nevada,CA,"Nevada, CA",61358,0,2118,90771,-29413,0.68
 2020,Nevada,CA,"Nevada, CA",65652,7,2348,100629,-34977,0.65
 2021,Nevada,CA,"Nevada, CA",68973,5,2873,123129,-54156,0.56
 2019,New Castle,DE,"New Castle, DE",56930,0,1268,54343,2587,1.05
 2020,New Castle,DE,"New Castle, DE",59303,4,1427,61157,-1854,0.97
 2021,New Castle,DE,"New Castle, DE",63189,7,1512,64800,-1611,0.98
 2019,New Hanover,NC,"New Hanover, NC",50960,0,1740,74571,-23611,0.68
 2020,New Hanover,NC,"New Hanover, NC",54391,7,1818,77914,-23523,0.7
 2021,New Hanover,NC,"New Hanover, NC",57693,6,2272,97371,-39678,0.59
 2019,New Haven,CT,"New Haven, CT",56888,0,1330,57000,-112,1
 2020,New Haven,CT,"New Haven, CT",60128,6,1335,57214,2914,1.05
 2021,New Haven,CT,"New Haven, CT",64643,8,1567,67157,-2514,0.96
 2019,New Kent,VA,"New Kent, VA",82110,0,1523,65271,16839,1.26
 2020,New Kent,VA,"New Kent, VA",85427,4,1642,70371,15056,1.21
 2021,New Kent,VA,"New Kent, VA",90086,6,1774,76029,14057,1.18
 2019,New London,CT,"New London, CT",58362,0,1339,57386,976,1.02
 2020,New London,CT,"New London, CT",61222,5,1433,61414,-192,1
 2021,New London,CT,"New London, CT",63877,4,1655,70929,-7052,0.9
 2019,New Madrid,MO,"New Madrid, MO",37247,0,218,9343,27904,3.99
 2020,New Madrid,MO,"New Madrid, MO",43079,16,443,18986,24093,2.27
 2021,New Madrid,MO,"New Madrid, MO",49093,14,478,20486,28607,2.4
 2019,New York,NY,"New York, NY",173525,0,8176,350400,-176875,0.5
 2020,New York,NY,"New York, NY",175327,1,8314,356314,-180987,0.49
 2021,New York,NY,"New York, NY",195543,12,7392,316800,-121257,0.62
 2019,Newaygo,MI,"Newaygo, MI",38065,0,802,34371,3694,1.11
 2020,Newaygo,MI,"Newaygo, MI",42134,11,850,36429,5705,1.16
 2021,Newaygo,MI,"Newaygo, MI",44597,6,986,42257,2340,1.06
 2019,Newberry,SC,"Newberry, SC",40342,0,1080,46286,-5944,0.87
 2020,Newberry,SC,"Newberry, SC",43190,7,970,41571,1619,1.04
 2021,Newberry,SC,"Newberry, SC",46917,9,1429,61243,-14326,0.77
 2019,Newport,RI,"Newport, RI",73416,0,2820,120857,-47441,0.61
 2020,Newport,RI,"Newport, RI",78693,7,2912,124800,-46107,0.63
 2021,Newport,RI,"Newport, RI",84054,7,3466,148543,-64489,0.57
 2019,Newton,AR,"Newton, AR",32564,0,747,32014,550,1.02
 2020,Newton,AR,"Newton, AR",35371,9,978,41914,-6543,0.84
 2021,Newton,AR,"Newton, AR",38629,9,1353,57986,-19357,0.67
 2019,Newton,GA,"Newton, GA",35126,0,1150,49286,-14160,0.71
 2020,Newton,GA,"Newton, GA",38449,10,1125,48214,-9765,0.8
 2021,Newton,GA,"Newton, GA",42056,9,1480,63429,-21373,0.66
 2019,Newton,IN,"Newton, IN",41129,0,473,20271,20858,2.03
 2020,Newton,IN,"Newton, IN",45837,11,675,28929,16908,1.58
 2021,Newton,IN,"Newton, IN",51905,13,542,23229,28676,2.23
 2019,Newton,MO,"Newton, MO",39711,0,799,34243,5468,1.16
 2020,Newton,MO,"Newton, MO",42442,7,952,40800,1642,1.04
 2021,Newton,MO,"Newton, MO",45190,7,1123,48129,-2939,0.94
 2019,Newton,MS,"Newton, MS",35654,0,681,29186,6468,1.22
 2020,Newton,MS,"Newton, MS",36925,4,607,26014,10911,1.42
 2021,Newton,MS,"Newton, MS",41367,12,750,32143,9224,1.29
 2019,Newton,TX,"Newton, TX",38416,0,624,26743,11673,1.44
 2020,Newton,TX,"Newton, TX",40957,7,599,25671,15286,1.6
 2021,Newton,TX,"Newton, TX",43123,5,774,33171,9952,1.3
 2019,Nez Perce,ID,"Nez Perce, ID",44537,0,1163,49843,-5306,0.89
 2020,Nez Perce,ID,"Nez Perce, ID",48279,8,1320,56571,-8292,0.85
 2021,Nez Perce,ID,"Nez Perce, ID",50993,6,1784,76457,-25464,0.67
 2019,Niagara,NY,"Niagara, NY",46393,0,628,26914,19479,1.72
 2020,Niagara,NY,"Niagara, NY",51017,10,693,29700,21317,1.72
 2021,Niagara,NY,"Niagara, NY",53137,4,839,35957,17180,1.48
 2019,Nicholas,KY,"Nicholas, KY",34420,0,557,23871,10549,1.44
 2020,Nicholas,KY,"Nicholas, KY",37934,10,542,23229,14705,1.63
 2021,Nicholas,KY,"Nicholas, KY",41414,9,1031,44186,-2772,0.94
 2019,Nicholas,WV,"Nicholas, WV",35542,0,671,28757,6785,1.24
 2020,Nicholas,WV,"Nicholas, WV",38165,7,744,31886,6279,1.2
 2021,Nicholas,WV,"Nicholas, WV",40915,7,718,30771,10144,1.33
 2019,Nicollet,MN,"Nicollet, MN",50427,0,1206,51686,-1259,0.98
 2020,Nicollet,MN,"Nicollet, MN",53688,7,1317,56443,-2755,0.95
 2021,Nicollet,MN,"Nicollet, MN",56992,6,1411,60471,-3479,0.94
 2019,Niobrara,WY,"Niobrara, WY",45633,0,1197,51300,-5667,0.89
 2020,Niobrara,WY,"Niobrara, WY",50469,11,899,38529,11940,1.31
 2021,Niobrara,WY,"Niobrara, WY",53797,7,614,26314,27483,2.04
 2019,Noble,IN,"Noble, IN",41110,0,690,29571,11539,1.39
 2020,Noble,IN,"Noble, IN",44250,8,746,31971,12279,1.38
 2021,Noble,IN,"Noble, IN",48060,9,1105,47357,703,1.01
 2019,Noble,OH,"Noble, OH",28633,0,557,23871,4762,1.2
 2020,Noble,OH,"Noble, OH",31322,9,868,37200,-5878,0.84
 2021,Noble,OH,"Noble, OH",32713,4,863,36986,-4273,0.88
 2019,Noble,OK,"Noble, OK",45429,0,537,23014,22415,1.97
 2020,Noble,OK,"Noble, OK",47928,6,357,15300,32628,3.13
 2021,Noble,OK,"Noble, OK",51172,7,874,37457,13715,1.37
 2019,Nobles,MN,"Nobles, MN",43841,0,841,36043,7798,1.22
 2020,Nobles,MN,"Nobles, MN",52093,19,877,37586,14507,1.39
 2021,Nobles,MN,"Nobles, MN",54479,5,922,39514,14965,1.38
 2019,Nodaway,MO,"Nodaway, MO",33241,0,692,29657,3584,1.12
 2020,Nodaway,MO,"Nodaway, MO",37241,12,642,27514,9727,1.35
 2021,Nodaway,MO,"Nodaway, MO",39258,5,760,32571,6687,1.21
 2019,Nolan,TX,"Nolan, TX",45680,0,560,24000,21680,1.9
 2020,Nolan,TX,"Nolan, TX",47428,4,611,26186,21242,1.81
 2021,Nolan,TX,"Nolan, TX",52629,11,716,30686,21943,1.72
 2019,Nome,AK,"Nome, AK",52541,0,1117,47871,4670,1.1
 2020,Nome,AK,"Nome, AK",54275,3,1123,48129,6146,1.13
 2021,Nome,AK,"Nome, AK",58882,9,432,18514,40368,3.18
 2019,Norfolk,MA,"Norfolk, MA",93360,0,2897,124157,-30797,0.75
 2020,Norfolk,MA,"Norfolk, MA",97787,5,3102,132943,-35156,0.74
 2021,Norfolk,MA,"Norfolk, MA",104059,6,3431,147043,-42984,0.71
 2019,Norman,MN,"Norman, MN",37092,0,425,18214,18878,2.04
 2020,Norman,MN,"Norman, MN",49702,34,420,18000,31702,2.76
 2021,Norman,MN,"Norman, MN",56502,14,347,14871,41631,3.8
 2019,North Slope,AK,"North Slope, AK",80223,0,1583,67843,12380,1.18
 2020,North Slope,AK,"North Slope, AK",75612,-6,870,37286,38326,2.03
 2021,North Slope,AK,"North Slope, AK",73320,-3,998,42771,30549,1.71
 2019,Northampton,NC,"Northampton, NC",39114,0,687,29443,9671,1.33
 2020,Northampton,NC,"Northampton, NC",41617,6,840,36000,5617,1.16
 2021,Northampton,NC,"Northampton, NC",46742,12,460,19714,27028,2.37
 2019,Northampton,PA,"Northampton, PA",56142,0,1161,49757,6385,1.13
 2020,Northampton,PA,"Northampton, PA",59080,5,1321,56614,2466,1.04
 2021,Northampton,PA,"Northampton, PA",63256,7,1516,64971,-1715,0.97
 2019,Northampton,VA,"Northampton, VA",54353,0,1587,68014,-13661,0.8
 2020,Northampton,VA,"Northampton, VA",59199,9,1426,61114,-1915,0.97
 2021,Northampton,VA,"Northampton, VA",63928,8,2585,110786,-46858,0.58
 2019,Northwest Arctic,AK,"Northwest Arctic, AK",48691,0,508,21771,26920,2.24
 2020,Northwest Arctic,AK,"Northwest Arctic, AK",50076,3,2078,89057,-38981,0.56
 2021,Northwest Arctic,AK,"Northwest Arctic, AK",52915,6,2038,87343,-34428,0.61
 2019,Norton,KS,"Norton, KS",41323,0,598,25629,15694,1.61
 2020,Norton,KS,"Norton, KS",48656,18,500,21429,27227,2.27
 2021,Norton,KS,"Norton, KS",51714,6,426,18257,33457,2.83
 2019,Nottoway,VA,"Nottoway, VA",34437,0,639,27386,7051,1.26
 2020,Nottoway,VA,"Nottoway, VA",37229,8,926,39686,-2457,0.94
 2021,Nottoway,VA,"Nottoway, VA",42851,15,937,40157,2694,1.07
 2019,Nowata,OK,"Nowata, OK",40117,0,630,27000,13117,1.49
 2020,Nowata,OK,"Nowata, OK",42909,7,470,20143,22766,2.13
 2021,Nowata,OK,"Nowata, OK",46337,8,393,16843,29494,2.75
 2019,Noxubee,MS,"Noxubee, MS",35266,0,500,21429,13837,1.65
 2020,Noxubee,MS,"Noxubee, MS",38306,9,419,17957,20349,2.13
 2021,Noxubee,MS,"Noxubee, MS",44360,16,377,16157,28203,2.75
 2019,Nuckolls,NE,"Nuckolls, NE",53019,0,1333,57129,-4110,0.93
 2020,Nuckolls,NE,"Nuckolls, NE",59933,13,364,15600,44333,3.84
 2021,Nuckolls,NE,"Nuckolls, NE",68062,14,458,19629,48433,3.47
 2019,Nueces,TX,"Nueces, TX",47242,0,1199,51386,-4144,0.92
 2020,Nueces,TX,"Nueces, TX",49149,4,1247,53443,-4294,0.92
 2021,Nueces,TX,"Nueces, TX",52852,8,1331,57043,-4191,0.93
 2019,Nye,NV,"Nye, NV",37624,0,1386,59400,-21776,0.63
 2020,Nye,NV,"Nye, NV",39534,5,1389,59529,-19995,0.66
 2021,Nye,NV,"Nye, NV",42796,8,1455,62357,-19561,0.69
 2019,O'brien,IA,"O'brien, IA",53495,0,516,22114,31381,2.42
 2020,O'brien,IA,"O'brien, IA",55875,4,641,27471,28404,2.03
 2021,O'brien,IA,"O'brien, IA",61882,11,684,29314,32568,2.11
 2019,Obion,TN,"Obion, TN",40375,0,597,25586,14789,1.58
 2020,Obion,TN,"Obion, TN",43488,8,635,27214,16274,1.6
 2021,Obion,TN,"Obion, TN",48493,12,757,32443,16050,1.49
 2019,Ocean,NJ,"Ocean, NJ",53315,0,1545,66214,-12899,0.81
 2020,Ocean,NJ,"Ocean, NJ",56831,7,1664,71314,-14483,0.8
 2021,Ocean,NJ,"Ocean, NJ",60823,7,1973,84557,-23734,0.72
 2019,Oceana,MI,"Oceana, MI",39469,0,1106,47400,-7931,0.83
 2020,Oceana,MI,"Oceana, MI",43760,11,1053,45129,-1369,0.97
 2021,Oceana,MI,"Oceana, MI",46015,5,1547,66300,-20285,0.69
 2019,Ochiltree,TX,"Ochiltree, TX",58559,0,737,31586,26973,1.85
 2020,Ochiltree,TX,"Ochiltree, TX",55494,-5,678,29057,26437,1.91
 2021,Ochiltree,TX,"Ochiltree, TX",64247,16,669,28671,35576,2.24
 2019,Oconee,GA,"Oconee, GA",70400,0,2098,89914,-19514,0.78
 2020,Oconee,GA,"Oconee, GA",72145,3,2235,95786,-23641,0.75
 2021,Oconee,GA,"Oconee, GA",76403,6,2692,115371,-38968,0.66
 2019,Oconee,SC,"Oconee, SC",46804,0,1319,56529,-9725,0.83
 2020,Oconee,SC,"Oconee, SC",48945,5,1430,61286,-12341,0.8
 2021,Oconee,SC,"Oconee, SC",52336,7,1508,64629,-12293,0.81
 2019,Oconto,WI,"Oconto, WI",47656,0,666,28543,19113,1.67
 2020,Oconto,WI,"Oconto, WI",50519,6,813,34843,15676,1.45
 2021,Oconto,WI,"Oconto, WI",53114,5,1047,44871,8243,1.18
 2019,Ogemaw,MI,"Ogemaw, MI",34956,0,548,23486,11470,1.49
 2020,Ogemaw,MI,"Ogemaw, MI",39841,14,620,26571,13270,1.5
 2021,Ogemaw,MI,"Ogemaw, MI",42781,7,859,36814,5967,1.16
 2019,Oglala Lakota,SD,"Oglala Lakota, SD",26352,0,4413,189129,-162777,0.14
 2019,Ogle,IL,"Ogle, IL",45804,0,867,37157,8647,1.23
 2020,Ogle,IL,"Ogle, IL",48779,7,836,35829,12950,1.36
 2021,Ogle,IL,"Ogle, IL",53050,9,880,37714,15336,1.41
 2019,Oglethorpe,GA,"Oglethorpe, GA",38746,0,1151,49329,-10583,0.79
 2020,Oglethorpe,GA,"Oglethorpe, GA",39427,2,1135,48643,-9216,0.81
 2021,Oglethorpe,GA,"Oglethorpe, GA",43517,10,1454,62314,-18797,0.7
 2019,Ohio,IN,"Ohio, IN",41348,0,734,31457,9891,1.31
 2020,Ohio,IN,"Ohio, IN",47762,16,1215,52071,-4309,0.92
 2021,Ohio,IN,"Ohio, IN",51321,8,867,37157,14164,1.38
 2019,Ohio,KY,"Ohio, KY",33468,0,613,26271,7197,1.27
 2020,Ohio,KY,"Ohio, KY",36448,9,683,29271,7177,1.25
 2021,Ohio,KY,"Ohio, KY",41201,13,845,36214,4987,1.14
 2019,Ohio,WV,"Ohio, WV",59962,0,764,32743,27219,1.83
 2020,Ohio,WV,"Ohio, WV",57177,-5,672,28800,28377,1.99
 2021,Ohio,WV,"Ohio, WV",61486,8,847,36300,25186,1.69
 2019,Okaloosa,FL,"Okaloosa, FL",51512,0,1542,66086,-14574,0.78
 2020,Okaloosa,FL,"Okaloosa, FL",54934,7,1812,77657,-22723,0.71
 2021,Okaloosa,FL,"Okaloosa, FL",59384,8,1976,84686,-25302,0.7
 2019,Okanogan,WA,"Okanogan, WA",42429,0,1494,64029,-21600,0.66
 2020,Okanogan,WA,"Okanogan, WA",47732,13,1342,57514,-9782,0.83
 2021,Okanogan,WA,"Okanogan, WA",50517,6,1936,82971,-32454,0.61
 2019,Okeechobee,FL,"Okeechobee, FL",33555,0,880,37714,-4159,0.89
 2020,Okeechobee,FL,"Okeechobee, FL",35985,7,1110,47571,-11586,0.76
 2021,Okeechobee,FL,"Okeechobee, FL",39747,11,1709,73243,-33496,0.54
 2019,Okfuskee,OK,"Okfuskee, OK",32870,0,544,23314,9556,1.41
 2020,Okfuskee,OK,"Okfuskee, OK",34939,6,550,23571,11368,1.48
 2021,Okfuskee,OK,"Okfuskee, OK",37839,8,829,35529,2310,1.07
 2019,Oklahoma,OK,"Oklahoma, OK",56727,0,1226,52543,4184,1.08
 2020,Oklahoma,OK,"Oklahoma, OK",58984,4,1371,58757,227,1
 2021,Oklahoma,OK,"Oklahoma, OK",63151,7,1504,64457,-1306,0.98
 2019,Okmulgee,OK,"Okmulgee, OK",36446,0,352,15086,21360,2.42
 2020,Okmulgee,OK,"Okmulgee, OK",38936,7,378,16200,22736,2.4
 2021,Okmulgee,OK,"Okmulgee, OK",41808,7,522,22371,19437,1.87
 2019,Oktibbeha,MS,"Oktibbeha, MS",34454,0,1202,51514,-17060,0.67
 2020,Oktibbeha,MS,"Oktibbeha, MS",36768,7,1303,55843,-19075,0.66
 2021,Oktibbeha,MS,"Oktibbeha, MS",38463,5,1296,55543,-17080,0.69
 2019,Oldham,KY,"Oldham, KY",66002,0,1892,81086,-15084,0.81
 2020,Oldham,KY,"Oldham, KY",68532,4,1985,85071,-16539,0.81
 2021,Oldham,KY,"Oldham, KY",73110,7,2064,88457,-15347,0.83
 2019,Oldham,TX,"Oldham, TX",63100,0,1541,66043,-2943,0.96
 2020,Oldham,TX,"Oldham, TX",67945,8,1319,56529,11416,1.2
 2021,Oldham,TX,"Oldham, TX",72126,6,892,38229,33897,1.89
 2019,Oliver,ND,"Oliver, ND",45448,0,756,32400,13048,1.4
 2020,Oliver,ND,"Oliver, ND",52046,15,659,28243,23803,1.84
 2021,Oliver,ND,"Oliver, ND",63441,22,911,39043,24398,1.62
 2019,Olmsted,MN,"Olmsted, MN",58724,0,1646,70543,-11819,0.83
 2020,Olmsted,MN,"Olmsted, MN",62179,6,1734,74314,-12135,0.84
 2021,Olmsted,MN,"Olmsted, MN",65959,6,1858,79629,-13670,0.83
 2019,Oneida,ID,"Oneida, ID",38402,0,1018,43629,-5227,0.88
 2020,Oneida,ID,"Oneida, ID",42200,10,972,41657,543,1.01
 2021,Oneida,ID,"Oneida, ID",44887,6,1967,84300,-39413,0.53
 2019,Oneida,NY,"Oneida, NY",46034,0,636,27257,18777,1.69
 2020,Oneida,NY,"Oneida, NY",49821,8,703,30129,19692,1.65
 2021,Oneida,NY,"Oneida, NY",53172,7,899,38529,14643,1.38
 2019,Oneida,WI,"Oneida, WI",50147,0,1087,46586,3561,1.08
 2020,Oneida,WI,"Oneida, WI",53044,6,1054,45171,7873,1.17
 2021,Oneida,WI,"Oneida, WI",55861,5,1063,45557,10304,1.23
 2019,Onondaga,NY,"Onondaga, NY",52978,0,979,41957,11021,1.26
 2020,Onondaga,NY,"Onondaga, NY",57760,9,927,39729,18031,1.45
 2021,Onondaga,NY,"Onondaga, NY",60992,6,900,38571,22421,1.58
 2019,Onslow,NC,"Onslow, NC",44307,0,1009,43243,1064,1.02
 2020,Onslow,NC,"Onslow, NC",46972,6,1013,43414,3558,1.08
 2021,Onslow,NC,"Onslow, NC",50869,8,1188,50914,-45,1
 2019,Ontario,NY,"Ontario, NY",55262,0,1326,56829,-1567,0.97
 2020,Ontario,NY,"Ontario, NY",59177,7,1438,61629,-2452,0.96
 2021,Ontario,NY,"Ontario, NY",62051,5,1762,75514,-13463,0.82
 2019,Ontonagon,MI,"Ontonagon, MI",40398,0,443,18986,21412,2.13
 2020,Ontonagon,MI,"Ontonagon, MI",45324,12,470,20143,25181,2.25
 2021,Ontonagon,MI,"Ontonagon, MI",47563,5,603,25843,21720,1.84
 2019,Orange,CA,"Orange, CA",70539,0,3931,168471,-97932,0.42
 2020,Orange,CA,"Orange, CA",75737,7,4511,193329,-117592,0.39
 2021,Orange,CA,"Orange, CA",81034,7,4739,203100,-122066,0.4
 2019,Orange,FL,"Orange, FL",46649,0,1608,68914,-22265,0.68
 2020,Orange,FL,"Orange, FL",49597,6,1703,72986,-23389,0.68
 2021,Orange,FL,"Orange, FL",54979,11,1583,67843,-12864,0.81
 2019,Orange,IN,"Orange, IN",37776,0,506,21686,16090,1.74
 2020,Orange,IN,"Orange, IN",40516,7,535,22929,17587,1.77
 2021,Orange,IN,"Orange, IN",43422,7,589,25243,18179,1.72
 2019,Orange,NC,"Orange, NC",66970,0,1988,85200,-18230,0.79
 2020,Orange,NC,"Orange, NC",69593,4,2201,94329,-24736,0.74
 2021,Orange,NC,"Orange, NC",74994,8,2440,104571,-29577,0.72
 2019,Orange,NY,"Orange, NY",51803,0,1454,62314,-10511,0.83
 2020,Orange,NY,"Orange, NY",55348,7,1631,69900,-14552,0.79
 2021,Orange,NY,"Orange, NY",58883,6,1867,80014,-21131,0.74
 2019,Orange,TX,"Orange, TX",45318,0,752,32229,13089,1.41
 2020,Orange,TX,"Orange, TX",46968,4,799,34243,12725,1.37
 2021,Orange,TX,"Orange, TX",48912,4,915,39214,9698,1.25
 2019,Orange,VA,"Orange, VA",52574,0,1450,62143,-9569,0.85
 2020,Orange,VA,"Orange, VA",55369,5,1618,69343,-13974,0.8
 2021,Orange,VA,"Orange, VA",57849,5,1797,77014,-19165,0.75
 2019,Orange,VT,"Orange, VT",49622,0,1075,46071,3551,1.08
 2020,Orange,VT,"Orange, VT",53314,7,1107,47443,5871,1.12
 2021,Orange,VT,"Orange, VT",55573,4,1396,59829,-4256,0.93
 2019,Orangeburg,SC,"Orangeburg, SC",35639,0,720,30857,4782,1.15
 2020,Orangeburg,SC,"Orangeburg, SC",38860,9,772,33086,5774,1.17
 2021,Orangeburg,SC,"Orangeburg, SC",42376,9,1123,48129,-5753,0.88
 2019,Oregon,MO,"Oregon, MO",37005,0,503,21557,15448,1.72
 2020,Oregon,MO,"Oregon, MO",40775,10,455,19500,21275,2.09
 2021,Oregon,MO,"Oregon, MO",42966,5,669,28671,14295,1.5
 2019,Orleans,LA,"Orleans, LA",54357,0,1652,70800,-16443,0.77
 2020,Orleans,LA,"Orleans, LA",58233,7,1665,71357,-13124,0.82
 2021,Orleans,LA,"Orleans, LA",62249,7,1831,78471,-16222,0.79
 2019,Orleans,NY,"Orleans, NY",39657,0,473,20271,19386,1.96
 2020,Orleans,NY,"Orleans, NY",44078,11,517,22157,21921,1.99
 2021,Orleans,NY,"Orleans, NY",46322,5,618,26486,19836,1.75
 2019,Orleans,VT,"Orleans, VT",45632,0,1067,45729,-97,1
 2020,Orleans,VT,"Orleans, VT",49879,9,957,41014,8865,1.22
 2021,Orleans,VT,"Orleans, VT",51960,4,1423,60986,-9026,0.85
 2019,Osage,KS,"Osage, KS",42907,0,527,22586,20321,1.9
 2020,Osage,KS,"Osage, KS",47130,10,527,22586,24544,2.09
 2021,Osage,KS,"Osage, KS",50353,7,656,28114,22239,1.79
 2019,Osage,MO,"Osage, MO",46003,0,624,26743,19260,1.72
 2020,Osage,MO,"Osage, MO",49948,9,855,36643,13305,1.36
 2021,Osage,MO,"Osage, MO",52701,6,899,38529,14172,1.37
 2019,Osage,OK,"Osage, OK",37056,0,881,37757,-701,0.98
 2020,Osage,OK,"Osage, OK",39439,6,1054,45171,-5732,0.87
 2021,Osage,OK,"Osage, OK",42015,7,1132,48514,-6499,0.87
 2019,Osborne,KS,"Osborne, KS",47061,0,216,9257,37804,5.08
 2020,Osborne,KS,"Osborne, KS",51497,9,392,16800,34697,3.07
 2021,Osborne,KS,"Osborne, KS",55815,8,795,34071,21744,1.64
 2019,Osceola,FL,"Osceola, FL",36498,0,1311,56186,-19688,0.65
 2020,Osceola,FL,"Osceola, FL",39421,8,1445,61929,-22508,0.64
 2021,Osceola,FL,"Osceola, FL",43354,10,1485,63643,-20289,0.68
 2019,Osceola,IA,"Osceola, IA",48717,0,585,25071,23646,1.94
 2020,Osceola,IA,"Osceola, IA",48976,1,668,28629,20347,1.71
 2021,Osceola,IA,"Osceola, IA",55063,12,741,31757,23306,1.73
 2019,Osceola,MI,"Osceola, MI",39164,0,569,24386,14778,1.61
 2020,Osceola,MI,"Osceola, MI",43341,11,600,25714,17627,1.69
 2021,Osceola,MI,"Osceola, MI",45167,4,807,34586,10581,1.31
 2019,Oscoda,MI,"Oscoda, MI",34885,0,383,16414,18471,2.13
 2020,Oscoda,MI,"Oscoda, MI",37619,8,515,22071,15548,1.7
 2021,Oscoda,MI,"Oscoda, MI",39929,6,595,25500,14429,1.57
 2019,Oswego,NY,"Oswego, NY",41695,0,575,24643,17052,1.69
 2020,Oswego,NY,"Oswego, NY",45855,10,665,28500,17355,1.61
 2021,Oswego,NY,"Oswego, NY",48574,6,749,32100,16474,1.51
 2019,Otero,CO,"Otero, CO",36070,0,617,26443,9627,1.36
 2020,Otero,CO,"Otero, CO",39281,9,618,26486,12795,1.48
 2021,Otero,CO,"Otero, CO",42752,9,896,38400,4352,1.11
 2019,Otero,NM,"Otero, NM",35385,0,890,38143,-2758,0.93
 2020,Otero,NM,"Otero, NM",38978,10,934,40029,-1051,0.97
 2021,Otero,NM,"Otero, NM",41657,7,1214,52029,-10372,0.8
 2019,Otoe,NE,"Otoe, NE",55614,0,872,37371,18243,1.49
 2020,Otoe,NE,"Otoe, NE",58784,6,758,32486,26298,1.81
 2021,Otoe,NE,"Otoe, NE",63569,8,807,34586,28983,1.84
 2019,Otsego,MI,"Otsego, MI",41441,0,810,34714,6727,1.19
 2020,Otsego,MI,"Otsego, MI",46664,13,851,36471,10193,1.28
 2021,Otsego,MI,"Otsego, MI",49320,6,1038,44486,4834,1.11
 2019,Otsego,NY,"Otsego, NY",46240,0,947,40586,5654,1.14
 2020,Otsego,NY,"Otsego, NY",50111,8,892,38229,11882,1.31
 2021,Otsego,NY,"Otsego, NY",53431,7,1186,50829,2602,1.05
 2019,Ottawa,KS,"Ottawa, KS",41724,0,513,21986,19738,1.9
 2020,Ottawa,KS,"Ottawa, KS",46244,11,593,25414,20830,1.82
 2021,Ottawa,KS,"Ottawa, KS",50373,9,684,29314,21059,1.72
 2019,Ottawa,MI,"Ottawa, MI",49800,0,1506,64543,-14743,0.77
 2020,Ottawa,MI,"Ottawa, MI",53507,7,1542,66086,-12579,0.81
 2021,Ottawa,MI,"Ottawa, MI",56076,5,1929,82671,-26595,0.68
 2019,Ottawa,OH,"Ottawa, OH",54124,0,1161,49757,4367,1.09
 2020,Ottawa,OH,"Ottawa, OH",57760,7,1314,56314,1446,1.03
 2021,Ottawa,OH,"Ottawa, OH",61102,6,1587,68014,-6912,0.9
 2019,Ottawa,OK,"Ottawa, OK",38936,0,409,17529,21407,2.22
 2020,Ottawa,OK,"Ottawa, OK",42066,8,375,16071,25995,2.62
 2021,Ottawa,OK,"Ottawa, OK",45484,8,408,17486,27998,2.6
 2019,Otter Tail,MN,"Otter Tail, MN",47353,0,1158,49629,-2276,0.95
 2020,Otter Tail,MN,"Otter Tail, MN",51840,10,1110,47571,4269,1.09
 2021,Otter Tail,MN,"Otter Tail, MN",55698,7,1283,54986,712,1.01
 2019,Ouachita,AR,"Ouachita, AR",39340,0,444,19029,20311,2.07
 2020,Ouachita,AR,"Ouachita, AR",42742,9,438,18771,23971,2.28
 2021,Ouachita,AR,"Ouachita, AR",46428,9,675,28929,17499,1.6
 2019,Ouachita,LA,"Ouachita, LA",40088,0,995,42643,-2555,0.94
 2020,Ouachita,LA,"Ouachita, LA",43726,9,1059,45386,-1660,0.96
 2021,Ouachita,LA,"Ouachita, LA",46804,7,1097,47014,-210,1
 2019,Ouray,CO,"Ouray, CO",67967,0,3358,143914,-75947,0.47
 2020,Ouray,CO,"Ouray, CO",72871,7,3393,145414,-72543,0.5
 2021,Ouray,CO,"Ouray, CO",76727,5,6331,271329,-194602,0.28
 2019,Outagamie,WI,"Outagamie, WI",52828,0,1362,58371,-5543,0.91
 2020,Outagamie,WI,"Outagamie, WI",55492,5,1354,58029,-2537,0.96
 2021,Outagamie,WI,"Outagamie, WI",58622,6,1534,65743,-7121,0.89
 2019,Overton,TN,"Overton, TN",35018,0,890,38143,-3125,0.92
 2020,Overton,TN,"Overton, TN",37812,8,1058,45343,-7531,0.83
 2021,Overton,TN,"Overton, TN",40959,8,1538,65914,-24955,0.62
 2019,Owen,IN,"Owen, IN",41009,0,851,36471,4538,1.12
 2020,Owen,IN,"Owen, IN",44533,9,828,35486,9047,1.25
 2021,Owen,IN,"Owen, IN",48681,9,1061,45471,3210,1.07
 2019,Owen,KY,"Owen, KY",33300,0,694,29743,3557,1.12
 2020,Owen,KY,"Owen, KY",36536,10,807,34586,1950,1.06
 2021,Owen,KY,"Owen, KY",39661,9,1078,46200,-6539,0.86
 2019,Owsley,KY,"Owsley, KY",33966,0,642,27514,6452,1.23
 2020,Owsley,KY,"Owsley, KY",39487,16,441,18900,20587,2.09
 2021,Owsley,KY,"Owsley, KY",45731,16,969,41529,4202,1.1
 2019,Owyhee,ID,"Owyhee, ID",39174,0,1236,52971,-13797,0.74
 2020,Owyhee,ID,"Owyhee, ID",41985,7,1651,70757,-28772,0.59
 2021,Owyhee,ID,"Owyhee, ID",43713,4,2286,97971,-54258,0.45
 2019,Oxford,ME,"Oxford, ME",39353,0,948,40629,-1276,0.97
 2020,Oxford,ME,"Oxford, ME",42694,9,914,39171,3523,1.09
 2021,Oxford,ME,"Oxford, ME",45332,6,1245,53357,-8025,0.85
 2019,Ozark,MO,"Ozark, MO",33351,0,778,33343,8,1
 2020,Ozark,MO,"Ozark, MO",36728,10,865,37071,-343,0.99
 2021,Ozark,MO,"Ozark, MO",38401,5,1391,59614,-21213,0.64
 2019,Ozaukee,WI,"Ozaukee, WI",85018,0,2000,85714,-696,0.99
 2020,Ozaukee,WI,"Ozaukee, WI",87897,3,2190,93857,-5960,0.94
 2021,Ozaukee,WI,"Ozaukee, WI",92719,6,2014,86314,6405,1.07
 2019,Pacific,WA,"Pacific, WA",41078,0,1242,53229,-12151,0.77
 2020,Pacific,WA,"Pacific, WA",43968,7,1357,58157,-14189,0.76
 2021,Pacific,WA,"Pacific, WA",46597,6,1789,76671,-30074,0.61
 2019,Page,IA,"Page, IA",42502,0,464,19886,22616,2.14
 2020,Page,IA,"Page, IA",47231,11,390,16714,30517,2.83
 2021,Page,IA,"Page, IA",52069,10,546,23400,28669,2.23
 2019,Page,VA,"Page, VA",39449,0,950,40714,-1265,0.97
 2020,Page,VA,"Page, VA",42618,8,1008,43200,-582,0.99
 2021,Page,VA,"Page, VA",47157,11,1347,57729,-10572,0.82
 2019,Palm Beach,FL,"Palm Beach, FL",89254,0,1793,76843,12411,1.16
 2020,Palm Beach,FL,"Palm Beach, FL",92773,4,1808,77486,15287,1.2
 2021,Palm Beach,FL,"Palm Beach, FL",100627,9,2308,98914,1713,1.02
 2019,Palo Alto,IA,"Palo Alto, IA",51403,0,634,27171,24232,1.89
 2020,Palo Alto,IA,"Palo Alto, IA",49216,-4,747,32014,17202,1.54
 2021,Palo Alto,IA,"Palo Alto, IA",56973,16,755,32357,24616,1.76
 2019,Palo Pinto,TX,"Palo Pinto, TX",45246,0,1691,72471,-27225,0.62
 2020,Palo Pinto,TX,"Palo Pinto, TX",47649,5,1814,77743,-30094,0.61
 2021,Palo Pinto,TX,"Palo Pinto, TX",52042,9,1723,73843,-21801,0.7
 2019,Pamlico,NC,"Pamlico, NC",46364,0,1420,60857,-14493,0.76
 2020,Pamlico,NC,"Pamlico, NC",49603,7,1528,65486,-15883,0.76
 2021,Pamlico,NC,"Pamlico, NC",53355,8,2011,86186,-32831,0.62
 2019,Panola,MS,"Panola, MS",34489,0,663,28414,6075,1.21
 2020,Panola,MS,"Panola, MS",38751,12,716,30686,8065,1.26
 2021,Panola,MS,"Panola, MS",42074,9,1029,44100,-2026,0.95
 2019,Panola,TX,"Panola, TX",48801,0,896,38400,10401,1.27
 2020,Panola,TX,"Panola, TX",48646,0,901,38614,10032,1.26
 2021,Panola,TX,"Panola, TX",53292,10,1394,59743,-6451,0.89
 2019,Park,CO,"Park, CO",49865,0,2011,86186,-36321,0.58
 2020,Park,CO,"Park, CO",53092,7,1974,84600,-31508,0.63
 2021,Park,CO,"Park, CO",57127,8,2991,128186,-71059,0.45
 2019,Park,MT,"Park, MT",51909,0,2080,89143,-37234,0.58
 2020,Park,MT,"Park, MT",55812,8,2420,103714,-47902,0.54
 2021,Park,MT,"Park, MT",59558,7,3055,130929,-71371,0.45
 2019,Park,WY,"Park, WY",60645,0,1597,68443,-7798,0.89
 2020,Park,WY,"Park, WY",62495,3,1901,81471,-18976,0.77
 2021,Park,WY,"Park, WY",65944,6,3117,133586,-67642,0.49
 2019,Parke,IN,"Parke, IN",39311,0,791,33900,5411,1.16
 2020,Parke,IN,"Parke, IN",44103,12,875,37500,6603,1.18
 2021,Parke,IN,"Parke, IN",48252,9,817,35014,13238,1.38
 2019,Parker,TX,"Parker, TX",58675,0,1672,71657,-12982,0.82
 2020,Parker,TX,"Parker, TX",61317,5,1722,73800,-12483,0.83
 2021,Parker,TX,"Parker, TX",65358,7,2258,96771,-31413,0.68
 2019,Parmer,TX,"Parmer, TX",50187,0,799,34243,15944,1.47
 2020,Parmer,TX,"Parmer, TX",55989,12,967,41443,14546,1.35
 2021,Parmer,TX,"Parmer, TX",63512,13,1136,48686,14826,1.3
 2019,Pasco,FL,"Pasco, FL",43822,0,1161,49757,-5935,0.88
 2020,Pasco,FL,"Pasco, FL",46696,7,1211,51900,-5204,0.9
 2021,Pasco,FL,"Pasco, FL",50479,8,1544,66171,-15692,0.76
 2019,Pasquotank,NC,"Pasquotank, NC",39929,0,954,40886,-957,0.98
 2020,Pasquotank,NC,"Pasquotank, NC",43165,8,985,42214,951,1.02
 2021,Pasquotank,NC,"Pasquotank, NC",47034,9,1071,45900,1134,1.02
 2019,Passaic,NJ,"Passaic, NJ",50421,0,1669,71529,-21108,0.7
 2020,Passaic,NJ,"Passaic, NJ",54514,8,1827,78300,-23786,0.7
 2021,Passaic,NJ,"Passaic, NJ",59559,9,1961,84043,-24484,0.71
 2019,Patrick,VA,"Patrick, VA",33781,0,795,34071,-290,0.99
 2020,Patrick,VA,"Patrick, VA",36637,9,815,34929,1708,1.05
 2021,Patrick,VA,"Patrick, VA",39564,8,1413,60557,-20993,0.65
 2019,Paulding,GA,"Paulding, GA",40700,0,1254,53743,-13043,0.76
 2020,Paulding,GA,"Paulding, GA",43662,7,1295,55500,-11838,0.79
 2021,Paulding,GA,"Paulding, GA",47381,9,1803,77271,-29890,0.61
 2019,Paulding,OH,"Paulding, OH",41315,0,476,20400,20915,2.03
 2020,Paulding,OH,"Paulding, OH",45740,11,452,19371,26369,2.36
 2021,Paulding,OH,"Paulding, OH",48972,7,432,18514,30458,2.65
 2019,Pawnee,KS,"Pawnee, KS",42043,0,342,14657,27386,2.87
 2020,Pawnee,KS,"Pawnee, KS",45468,8,350,15000,30468,3.03
 2021,Pawnee,KS,"Pawnee, KS",48441,7,554,23743,24698,2.04
 2019,Pawnee,NE,"Pawnee, NE",44972,0,531,22757,22215,1.98
 2020,Pawnee,NE,"Pawnee, NE",53131,18,375,16071,37060,3.31
 2021,Pawnee,NE,"Pawnee, NE",58774,11,808,34629,24145,1.7
 2019,Pawnee,OK,"Pawnee, OK",38894,0,548,23486,15408,1.66
 2020,Pawnee,OK,"Pawnee, OK",41104,6,527,22586,18518,1.82
 2021,Pawnee,OK,"Pawnee, OK",43859,7,581,24900,18959,1.76
 2019,Payette,ID,"Payette, ID",40739,0,1291,55329,-14590,0.74
 2020,Payette,ID,"Payette, ID",43076,6,1508,64629,-21553,0.67
 2021,Payette,ID,"Payette, ID",45796,6,2185,93643,-47847,0.49
 2019,Payne,OK,"Payne, OK",39008,0,919,39386,-378,0.99
 2020,Payne,OK,"Payne, OK",41541,7,875,37500,4041,1.11
 2021,Payne,OK,"Payne, OK",43952,6,855,36643,7309,1.2
 2019,Peach,GA,"Peach, GA",38358,0,823,35271,3087,1.09
 2020,Peach,GA,"Peach, GA",41231,8,813,34843,6388,1.18
 2021,Peach,GA,"Peach, GA",43641,6,831,35614,8027,1.23
 2019,Pearl River,MS,"Pearl River, MS",38224,0,858,36771,1453,1.04
 2020,Pearl River,MS,"Pearl River, MS",40667,6,845,36214,4453,1.12
 2021,Pearl River,MS,"Pearl River, MS",43214,6,1106,47400,-4186,0.91
 2019,Pecos,TX,"Pecos, TX",41260,0,710,30429,10831,1.36
 2020,Pecos,TX,"Pecos, TX",41006,-1,828,35486,5520,1.16
 2021,Pecos,TX,"Pecos, TX",43661,7,1114,47743,-4082,0.91
 2019,Pembina,ND,"Pembina, ND",58341,0,433,18557,39784,3.14
 2020,Pembina,ND,"Pembina, ND",71085,22,558,23914,47171,2.97
 2021,Pembina,ND,"Pembina, ND",75974,7,670,28714,47260,2.65
 2019,Pemiscot,MO,"Pemiscot, MO",36126,0,432,18514,17612,1.95
 2020,Pemiscot,MO,"Pemiscot, MO",40570,12,472,20229,20341,2.01
 2021,Pemiscot,MO,"Pemiscot, MO",46840,16,307,13157,33683,3.56
 2019,Pend Oreille,WA,"Pend Oreille, WA",44448,0,1314,56314,-11866,0.79
 2020,Pend Oreille,WA,"Pend Oreille, WA",48116,8,1478,63343,-15227,0.76
 2021,Pend Oreille,WA,"Pend Oreille, WA",51623,7,2804,120171,-68548,0.43
 2019,Pender,NC,"Pender, NC",42899,0,1567,67157,-24258,0.64
 2020,Pender,NC,"Pender, NC",45375,6,1610,69000,-23625,0.66
 2021,Pender,NC,"Pender, NC",48665,7,2299,98529,-49864,0.49
 2019,Pendleton,KY,"Pendleton, KY",45918,0,547,23443,22475,1.96
 2020,Pendleton,KY,"Pendleton, KY",46909,2,581,24900,22009,1.88
 2021,Pendleton,KY,"Pendleton, KY",51933,11,938,40200,11733,1.29
 2019,Pendleton,WV,"Pendleton, WV",42191,0,754,32314,9877,1.31
 2020,Pendleton,WV,"Pendleton, WV",45054,7,698,29914,15140,1.51
 2021,Pendleton,WV,"Pendleton, WV",50144,11,1363,58414,-8270,0.86
 2019,Pennington,MN,"Pennington, MN",54201,0,793,33986,20215,1.59
 2020,Pennington,MN,"Pennington, MN",59713,10,733,31414,28299,1.9
 2021,Pennington,MN,"Pennington, MN",65416,10,944,40457,24959,1.62
 2019,Pennington,SD,"Pennington, SD",56872,0,1295,55500,1372,1.02
 2020,Pennington,SD,"Pennington, SD",61312,8,1361,58329,2983,1.05
 2021,Pennington,SD,"Pennington, SD",64035,4,1635,70071,-6036,0.91
 2019,Penobscot,ME,"Penobscot, ME",43086,0,751,32186,10900,1.34
 2020,Penobscot,ME,"Penobscot, ME",47574,10,793,33986,13588,1.4
 2021,Penobscot,ME,"Penobscot, ME",50480,6,1019,43671,6809,1.16
 2019,Peoria,IL,"Peoria, IL",50204,0,603,25843,24361,1.94
 2020,Peoria,IL,"Peoria, IL",54337,8,555,23786,30551,2.28
 2021,Peoria,IL,"Peoria, IL",57439,6,486,20829,36610,2.76
 2019,Pepin,WI,"Pepin, WI",49977,0,1038,44486,5491,1.12
 2020,Pepin,WI,"Pepin, WI",54569,9,1241,53186,1383,1.03
 2021,Pepin,WI,"Pepin, WI",57620,6,1310,56143,1477,1.03
 2019,Perkins,NE,"Perkins, NE",64894,0,1237,53014,11880,1.22
 2020,Perkins,NE,"Perkins, NE",75072,16,662,28371,46701,2.65
 2021,Perkins,NE,"Perkins, NE",87847,17,1343,57557,30290,1.53
 2019,Perkins,SD,"Perkins, SD",40031,0,399,17100,22931,2.34
 2020,Perkins,SD,"Perkins, SD",46484,16,380,16286,30198,2.85
 2021,Perkins,SD,"Perkins, SD",50692,9,1140,48857,1835,1.04
 2019,Perquimans,NC,"Perquimans, NC",43540,0,1352,57943,-14403,0.75
 2020,Perquimans,NC,"Perquimans, NC",46690,7,1409,60386,-13696,0.77
 2021,Perquimans,NC,"Perquimans, NC",51577,11,1783,76414,-24837,0.67
 2019,Perry,AL,"Perry, AL",32885,0,512,21943,10942,1.5
 2020,Perry,AL,"Perry, AL",37160,13,603,25843,11317,1.44
 2021,Perry,AL,"Perry, AL",40414,9,621,26614,13800,1.52
 2019,Perry,AR,"Perry, AR",37206,0,650,27857,9349,1.34
 2020,Perry,AR,"Perry, AR",39715,7,508,21771,17944,1.82
 2021,Perry,AR,"Perry, AR",43793,10,888,38057,5736,1.15
 2019,Perry,IL,"Perry, IL",37650,0,375,16071,21579,2.34
 2020,Perry,IL,"Perry, IL",41138,9,503,21557,19581,1.91
 2021,Perry,IL,"Perry, IL",43777,6,360,15429,28348,2.84
 2019,Perry,IN,"Perry, IN",37609,0,600,25714,11895,1.46
 2020,Perry,IN,"Perry, IN",39290,5,643,27557,11733,1.43
 2021,Perry,IN,"Perry, IN",42358,8,741,31757,10601,1.33
 2019,Perry,KY,"Perry, KY",35367,0,574,24600,10767,1.44
 2020,Perry,KY,"Perry, KY",39558,12,623,26700,12858,1.48
 2021,Perry,KY,"Perry, KY",44108,12,640,27429,16679,1.61
 2019,Perry,MO,"Perry, MO",42747,0,689,29529,13218,1.45
 2020,Perry,MO,"Perry, MO",45738,7,750,32143,13595,1.42
 2021,Perry,MO,"Perry, MO",48474,6,715,30643,17831,1.58
 2019,Perry,MS,"Perry, MS",34208,0,645,27643,6565,1.24
 2020,Perry,MS,"Perry, MS",37403,9,586,25114,12289,1.49
 2021,Perry,MS,"Perry, MS",40243,8,569,24386,15857,1.65
 2019,Perry,OH,"Perry, OH",39486,0,463,19843,19643,1.99
 2020,Perry,OH,"Perry, OH",43130,9,568,24343,18787,1.77
 2021,Perry,OH,"Perry, OH",46028,7,845,36214,9814,1.27
 2019,Perry,PA,"Perry, PA",46931,0,809,34671,12260,1.35
 2020,Perry,PA,"Perry, PA",50363,7,799,34243,16120,1.47
 2021,Perry,PA,"Perry, PA",53700,7,929,39814,13886,1.35
 2019,Perry,TN,"Perry, TN",34491,0,864,37029,-2538,0.93
 2020,Perry,TN,"Perry, TN",35934,4,1151,49329,-13395,0.73
 2021,Perry,TN,"Perry, TN",38404,7,1379,59100,-20696,0.65
 2019,Pershing,NV,"Pershing, NV",33070,0,411,17614,15456,1.88
 2020,Pershing,NV,"Pershing, NV",37287,13,1066,45686,-8399,0.82
 2021,Pershing,NV,"Pershing, NV",39688,6,1080,46286,-6598,0.86
 2019,Person,NC,"Person, NC",39670,0,1423,60986,-21316,0.65
 2020,Person,NC,"Person, NC",42737,8,1438,61629,-18892,0.69
 2021,Person,NC,"Person, NC",46879,10,1398,59914,-13035,0.78
 2019,Petersburg,AK,"Petersburg, AK",67946,0,1273,54557,13389,1.25
 2020,Petersburg,AK,"Petersburg, AK",70171,3,1224,52457,17714,1.34
 2021,Petersburg,AK,"Petersburg, AK",78295,12,1120,48000,30295,1.63
 2019,Petroleum,MT,"Petroleum, MT",34028,0,907,38871,-4843,0.88
 2020,Petroleum,MT,"Petroleum, MT",36335,7,917,39300,-2965,0.92
 2021,Petroleum,MT,"Petroleum, MT",31503,-13,1043,44700,-13197,0.7
 2019,Pettis,MO,"Pettis, MO",37712,0,591,25329,12383,1.49
 2020,Pettis,MO,"Pettis, MO",40827,8,611,26186,14641,1.56
 2021,Pettis,MO,"Pettis, MO",43693,7,656,28114,15579,1.55
 2019,Phelps,MO,"Phelps, MO",39464,0,785,33643,5821,1.17
 2020,Phelps,MO,"Phelps, MO",42213,7,881,37757,4456,1.12
 2021,Phelps,MO,"Phelps, MO",44205,5,796,34114,10091,1.3
 2019,Phelps,NE,"Phelps, NE",54090,0,751,32186,21904,1.68
 2020,Phelps,NE,"Phelps, NE",60264,11,708,30343,29921,1.99
 2021,Phelps,NE,"Phelps, NE",63430,5,791,33900,29530,1.87
 2019,Philadelphia,PA,"Philadelphia, PA",54010,0,1083,46414,7596,1.16
 2020,Philadelphia,PA,"Philadelphia, PA",56685,5,1237,53014,3671,1.07
 2021,Philadelphia,PA,"Philadelphia, PA",60869,7,1317,56443,4426,1.08
 2019,Phillips,AR,"Phillips, AR",35443,0,155,6643,28800,5.34
 2020,Phillips,AR,"Phillips, AR",41005,16,269,11529,29476,3.56
 2021,Phillips,AR,"Phillips, AR",45497,11,196,8400,37097,5.42
 2019,Phillips,CO,"Phillips, CO",42230,0,804,34457,7773,1.23
 2020,Phillips,CO,"Phillips, CO",44065,4,979,41957,2108,1.05
 2021,Phillips,CO,"Phillips, CO",50382,14,1176,50400,-18,1
 2019,Phillips,KS,"Phillips, KS",54479,0,473,20271,34208,2.69
 2020,Phillips,KS,"Phillips, KS",59484,9,394,16886,42598,3.52
 2021,Phillips,KS,"Phillips, KS",64720,9,543,23271,41449,2.78
 2019,Phillips,MT,"Phillips, MT",39054,0,955,40929,-1875,0.95
 2020,Phillips,MT,"Phillips, MT",43494,11,695,29786,13708,1.46
 2021,Phillips,MT,"Phillips, MT",44926,3,830,35571,9355,1.26
 2019,Piatt,IL,"Piatt, IL",52688,0,685,29357,23331,1.79
 2020,Piatt,IL,"Piatt, IL",57821,10,812,34800,23021,1.66
 2021,Piatt,IL,"Piatt, IL",63905,11,606,25971,37934,2.46
 2019,Pickaway,OH,"Pickaway, OH",42334,0,862,36943,5391,1.15
 2020,Pickaway,OH,"Pickaway, OH",46614,10,916,39257,7357,1.19
 2021,Pickaway,OH,"Pickaway, OH",49425,6,1369,58671,-9246,0.84
 2019,Pickens,AL,"Pickens, AL",35986,0,860,36857,-871,0.98
 2020,Pickens,AL,"Pickens, AL",38631,7,648,27771,10860,1.39
 2021,Pickens,AL,"Pickens, AL",43039,11,544,23314,19725,1.85
 2019,Pickens,GA,"Pickens, GA",49335,0,1496,64114,-14779,0.77
 2020,Pickens,GA,"Pickens, GA",51623,5,1652,70800,-19177,0.73
 2021,Pickens,GA,"Pickens, GA",55398,7,1883,80700,-25302,0.69
 2019,Pickens,SC,"Pickens, SC",39339,0,1253,53700,-14361,0.73
 2020,Pickens,SC,"Pickens, SC",41135,5,1390,59571,-18436,0.69
 2021,Pickens,SC,"Pickens, SC",43842,7,1449,62100,-18258,0.71
 2019,Pickett,TN,"Pickett, TN",40574,0,948,40629,-55,1
 2020,Pickett,TN,"Pickett, TN",42952,6,922,39514,3438,1.09
 2021,Pickett,TN,"Pickett, TN",45308,6,1852,79371,-34063,0.57
 2019,Pierce,GA,"Pierce, GA",36776,0,870,37286,-510,0.99
 2020,Pierce,GA,"Pierce, GA",39454,7,854,36600,2854,1.08
 2021,Pierce,GA,"Pierce, GA",41882,6,1260,54000,-12118,0.78
 2019,Pierce,ND,"Pierce, ND",48230,0,480,20571,27659,2.34
 2020,Pierce,ND,"Pierce, ND",56319,17,370,15857,40462,3.55
 2021,Pierce,ND,"Pierce, ND",66733,19,427,18300,48433,3.65
 2019,Pierce,NE,"Pierce, NE",57035,0,540,23143,33892,2.46
 2020,Pierce,NE,"Pierce, NE",62386,9,1094,46886,15500,1.33
 2021,Pierce,NE,"Pierce, NE",68647,10,510,21857,46790,3.14
 2019,Pierce,WA,"Pierce, WA",52389,0,2076,88971,-36582,0.59
 2020,Pierce,WA,"Pierce, WA",56467,8,2197,94157,-37690,0.6
 2021,Pierce,WA,"Pierce, WA",61580,9,2649,113529,-51949,0.54
 2019,Pierce,WI,"Pierce, WI",48704,0,1318,56486,-7782,0.86
 2020,Pierce,WI,"Pierce, WI",51123,5,1446,61971,-10848,0.82
 2021,Pierce,WI,"Pierce, WI",54429,7,1442,61800,-7371,0.88
 2019,Pike,AL,"Pike, AL",37580,0,708,30343,7237,1.24
 2020,Pike,AL,"Pike, AL",40730,8,726,31114,9616,1.31
 2021,Pike,AL,"Pike, AL",44659,10,998,42771,1888,1.04
 2019,Pike,AR,"Pike, AR",33089,0,619,26529,6560,1.25
 2020,Pike,AR,"Pike, AR",34971,6,686,29400,5571,1.19
 2021,Pike,AR,"Pike, AR",40806,17,1366,58543,-17737,0.7
 2019,Pike,GA,"Pike, GA",42398,0,1406,60257,-17859,0.7
 2020,Pike,GA,"Pike, GA",44985,6,1447,62014,-17029,0.73
 2021,Pike,GA,"Pike, GA",48643,8,2014,86314,-37671,0.56
 2019,Pike,IL,"Pike, IL",42460,0,401,17186,25274,2.47
 2020,Pike,IL,"Pike, IL",49038,16,358,15343,33695,3.2
 2021,Pike,IL,"Pike, IL",54377,11,664,28457,25920,1.91
 2019,Pike,IN,"Pike, IN",42008,0,527,22586,19422,1.86
 2020,Pike,IN,"Pike, IN",45073,7,815,34929,10144,1.29
 2021,Pike,IN,"Pike, IN",47977,6,646,27686,20291,1.73
 2019,Pike,KY,"Pike, KY",35348,0,704,30171,5177,1.17
 2020,Pike,KY,"Pike, KY",39062,11,781,33471,5591,1.17
 2021,Pike,KY,"Pike, KY",42691,9,872,37371,5320,1.14
 2019,Pike,MO,"Pike, MO",36936,0,544,23314,13622,1.58
 2020,Pike,MO,"Pike, MO",40344,9,419,17957,22387,2.25
 2021,Pike,MO,"Pike, MO",42546,6,655,28071,14475,1.52
 2019,Pike,MS,"Pike, MS",31391,0,584,25029,6362,1.25
 2020,Pike,MS,"Pike, MS",34320,9,608,26057,8263,1.32
 2021,Pike,MS,"Pike, MS",37461,9,823,35271,2190,1.06
 2019,Pike,OH,"Pike, OH",39758,0,710,30429,9329,1.31
 2020,Pike,OH,"Pike, OH",43639,10,764,32743,10896,1.33
 2021,Pike,OH,"Pike, OH",46730,7,907,38871,7859,1.2
 2019,Pike,PA,"Pike, PA",50137,0,853,36557,13580,1.37
 2020,Pike,PA,"Pike, PA",52415,5,941,40329,12086,1.3
 2021,Pike,PA,"Pike, PA",56008,7,1345,57643,-1635,0.97
 2019,Pima,AZ,"Pima, AZ",45996,0,1373,58843,-12847,0.78
 2020,Pima,AZ,"Pima, AZ",50131,9,1415,60643,-10512,0.83
 2021,Pima,AZ,"Pima, AZ",52942,6,1567,67157,-14215,0.79
 2019,Pinal,AZ,"Pinal, AZ",37402,0,1199,51386,-13984,0.73
 2020,Pinal,AZ,"Pinal, AZ",40979,10,1291,55329,-14350,0.74
 2021,Pinal,AZ,"Pinal, AZ",43793,7,1937,83014,-39221,0.53
 2019,Pine,MN,"Pine, MN",39550,0,881,37757,1793,1.05
 2020,Pine,MN,"Pine, MN",43572,10,929,39814,3758,1.09
 2021,Pine,MN,"Pine, MN",45538,5,1254,53743,-8205,0.85
 2019,Pinellas,FL,"Pinellas, FL",57635,0,1425,61071,-3436,0.94
 2020,Pinellas,FL,"Pinellas, FL",60996,6,1526,65400,-4404,0.93
 2021,Pinellas,FL,"Pinellas, FL",65936,8,1926,82543,-16607,0.8
 2019,Pipestone,MN,"Pipestone, MN",53252,0,626,26829,26423,1.98
 2020,Pipestone,MN,"Pipestone, MN",58005,9,661,28329,29676,2.05
 2021,Pipestone,MN,"Pipestone, MN",61106,5,574,24600,36506,2.48
 2019,Piscataquis,ME,"Piscataquis, ME",40332,0,715,30643,9689,1.32
 2020,Piscataquis,ME,"Piscataquis, ME",45711,13,682,29229,16482,1.56
 2021,Piscataquis,ME,"Piscataquis, ME",48987,7,909,38957,10030,1.26
 2019,Pitkin,CO,"Pitkin, CO",183241,0,9458,405343,-222102,0.45
 2020,Pitkin,CO,"Pitkin, CO",187595,2,11274,483171,-295576,0.39
 2021,Pitkin,CO,"Pitkin, CO",198939,6,10913,467700,-268761,0.43
 2019,Pitt,NC,"Pitt, NC",45951,0,986,42257,3694,1.09
 2020,Pitt,NC,"Pitt, NC",49350,7,1105,47357,1993,1.04
 2021,Pitt,NC,"Pitt, NC",53200,8,1253,53700,-500,0.99
 2019,Pittsburg,OK,"Pittsburg, OK",39340,0,733,31414,7926,1.25
 2020,Pittsburg,OK,"Pittsburg, OK",40110,2,892,38229,1881,1.05
 2021,Pittsburg,OK,"Pittsburg, OK",42102,5,817,35014,7088,1.2
 2019,Piute,UT,"Piute, UT",46797,0,865,37071,9726,1.26
 2020,Piute,UT,"Piute, UT",48017,3,1071,45900,2117,1.05
 2021,Piute,UT,"Piute, UT",49233,3,1778,76200,-26967,0.65
 2019,Placer,CA,"Placer, CA",68351,0,2791,119614,-51263,0.57
 2020,Placer,CA,"Placer, CA",73261,7,2909,124671,-51410,0.59
 2021,Placer,CA,"Placer, CA",76849,5,3367,144300,-67451,0.53
 2019,Plaquemines,LA,"Plaquemines, LA",47781,0,1303,55843,-8062,0.86
 2020,Plaquemines,LA,"Plaquemines, LA",51841,9,1529,65529,-13688,0.79
 2021,Plaquemines,LA,"Plaquemines, LA",55108,6,1644,70457,-15349,0.78
 2019,Platte,MO,"Platte, MO",58704,0,1791,76757,-18053,0.76
 2020,Platte,MO,"Platte, MO",60838,4,1897,81300,-20462,0.75
 2021,Platte,MO,"Platte, MO",63771,5,1928,82629,-18858,0.77
 2019,Platte,NE,"Platte, NE",48329,0,1177,50443,-2114,0.96
 2020,Platte,NE,"Platte, NE",52458,9,1232,52800,-342,0.99
 2021,Platte,NE,"Platte, NE",56149,7,1224,52457,3692,1.07
 2019,Platte,WY,"Platte, WY",51705,0,815,34929,16776,1.48
 2020,Platte,WY,"Platte, WY",51050,-1,867,37157,13893,1.37
 2021,Platte,WY,"Platte, WY",53368,5,1056,45257,8111,1.18
 2019,Pleasants,WV,"Pleasants, WV",43634,0,505,21643,21991,2.02
 2020,Pleasants,WV,"Pleasants, WV",45123,3,682,29229,15894,1.54
 2021,Pleasants,WV,"Pleasants, WV",49077,9,779,33386,15691,1.47
 2019,Plumas,CA,"Plumas, CA",50296,0,1908,81771,-31475,0.62
 2020,Plumas,CA,"Plumas, CA",54185,8,1846,79114,-24929,0.68
 2021,Plumas,CA,"Plumas, CA",57193,6,2389,102386,-45193,0.56
 2019,Plymouth,IA,"Plymouth, IA",55352,0,1039,44529,10823,1.24
 2020,Plymouth,IA,"Plymouth, IA",56761,3,1124,48171,8590,1.18
 2021,Plymouth,IA,"Plymouth, IA",63214,11,990,42429,20785,1.49
 2019,Plymouth,MA,"Plymouth, MA",69610,0,2354,100886,-31276,0.69
 2020,Plymouth,MA,"Plymouth, MA",75025,8,2481,106329,-31304,0.71
 2021,Plymouth,MA,"Plymouth, MA",79817,6,2718,116486,-36669,0.69
 2019,Pocahontas,IA,"Pocahontas, IA",51094,0,348,14914,36180,3.43
 2020,Pocahontas,IA,"Pocahontas, IA",49941,-2,356,15257,34684,3.27
 2021,Pocahontas,IA,"Pocahontas, IA",57640,15,404,17314,40326,3.33
 2019,Pocahontas,WV,"Pocahontas, WV",42925,0,725,31071,11854,1.38
 2020,Pocahontas,WV,"Pocahontas, WV",47166,10,707,30300,16866,1.56
 2021,Pocahontas,WV,"Pocahontas, WV",50236,7,861,36900,13336,1.36
 2019,Poinsett,AR,"Poinsett, AR",34645,0,485,20786,13859,1.67
 2020,Poinsett,AR,"Poinsett, AR",38591,11,529,22671,15920,1.7
 2021,Poinsett,AR,"Poinsett, AR",41551,8,414,17743,23808,2.34
 2019,Pointe Coupee,LA,"Pointe Coupee, LA",50714,0,1233,52843,-2129,0.96
 2020,Pointe Coupee,LA,"Pointe Coupee, LA",54571,8,1206,51686,2885,1.06
 2021,Pointe Coupee,LA,"Pointe Coupee, LA",58807,8,1144,49029,9778,1.2
 2019,Polk,AR,"Polk, AR",31293,0,656,28114,3179,1.11
 2020,Polk,AR,"Polk, AR",33816,8,686,29400,4416,1.15
 2021,Polk,AR,"Polk, AR",38178,13,867,37157,1021,1.03
 2019,Polk,FL,"Polk, FL",38196,0,1074,46029,-7833,0.83
 2020,Polk,FL,"Polk, FL",40970,7,1117,47871,-6901,0.86
 2021,Polk,FL,"Polk, FL",43556,6,1542,66086,-22530,0.66
 2019,Polk,GA,"Polk, GA",33504,0,717,30729,2775,1.09
 2020,Polk,GA,"Polk, GA",36171,8,884,37886,-1715,0.95
 2021,Polk,GA,"Polk, GA",39578,9,1039,44529,-4951,0.89
 2019,Polk,IA,"Polk, IA",54144,0,1299,55671,-1527,0.97
 2020,Polk,IA,"Polk, IA",57947,7,1230,52714,5233,1.1
 2021,Polk,IA,"Polk, IA",60799,5,1391,59614,1185,1.02
 2019,Polk,MN,"Polk, MN",46566,0,855,36643,9923,1.27
 2020,Polk,MN,"Polk, MN",53803,16,848,36343,17460,1.48
 2021,Polk,MN,"Polk, MN",58682,9,867,37157,21525,1.58
 2019,Polk,MO,"Polk, MO",36178,0,780,33429,2749,1.08
 2020,Polk,MO,"Polk, MO",38301,6,789,33814,4487,1.13
 2021,Polk,MO,"Polk, MO",41119,7,1335,57214,-16095,0.72
 2019,Polk,NC,"Polk, NC",51561,0,1853,79414,-27853,0.65
 2020,Polk,NC,"Polk, NC",54775,6,1791,76757,-21982,0.71
 2021,Polk,NC,"Polk, NC",59482,9,2867,122871,-63389,0.48
 2019,Polk,NE,"Polk, NE",53709,0,826,35400,18309,1.52
 2020,Polk,NE,"Polk, NE",57864,8,557,23871,33993,2.42
 2021,Polk,NE,"Polk, NE",65364,13,774,33171,32193,1.97
 2019,Polk,OR,"Polk, OR",43012,0,1753,75129,-32117,0.57
 2020,Polk,OR,"Polk, OR",45835,7,1807,77443,-31608,0.59
 2021,Polk,OR,"Polk, OR",49781,9,2506,107400,-57619,0.46
 2019,Polk,TN,"Polk, TN",33761,0,1201,51471,-17710,0.66
 2020,Polk,TN,"Polk, TN",35848,6,1256,53829,-17981,0.67
 2021,Polk,TN,"Polk, TN",39180,9,1666,71400,-32220,0.55
 2019,Polk,TX,"Polk, TX",43617,0,859,36814,6803,1.18
 2020,Polk,TX,"Polk, TX",45815,5,1049,44957,858,1.02
 2021,Polk,TX,"Polk, TX",47994,5,1074,46029,1965,1.04
 2019,Polk,WI,"Polk, WI",47004,0,1153,49414,-2410,0.95
 2020,Polk,WI,"Polk, WI",49919,6,1100,47143,2776,1.06
 2021,Polk,WI,"Polk, WI",52885,6,1423,60986,-8101,0.87
 2019,Pondera,MT,"Pondera, MT",49912,0,693,29700,20212,1.68
 2020,Pondera,MT,"Pondera, MT",56521,13,632,27086,29435,2.09
 2021,Pondera,MT,"Pondera, MT",52704,-7,777,33300,19404,1.58
 2019,Pontotoc,MS,"Pontotoc, MS",35400,0,919,39386,-3986,0.9
 2020,Pontotoc,MS,"Pontotoc, MS",38936,10,875,37500,1436,1.04
 2021,Pontotoc,MS,"Pontotoc, MS",41866,8,1105,47357,-5491,0.88
 2019,Pontotoc,OK,"Pontotoc, OK",45338,0,676,28971,16367,1.56
 2020,Pontotoc,OK,"Pontotoc, OK",48300,7,605,25929,22371,1.86
 2021,Pontotoc,OK,"Pontotoc, OK",51619,7,1039,44529,7090,1.16
 2019,Pope,AR,"Pope, AR",36057,0,753,32271,3786,1.12
 2020,Pope,AR,"Pope, AR",37465,4,917,39300,-1835,0.95
 2021,Pope,AR,"Pope, AR",40937,9,1108,47486,-6549,0.86
 2019,Pope,IL,"Pope, IL",32333,0,627,26871,5462,1.2
 2020,Pope,IL,"Pope, IL",37027,15,567,24300,12727,1.52
 2021,Pope,IL,"Pope, IL",39435,7,615,26357,13078,1.5
 2019,Pope,MN,"Pope, MN",50080,0,899,38529,11551,1.3
 2020,Pope,MN,"Pope, MN",55881,12,989,42386,13495,1.32
 2021,Pope,MN,"Pope, MN",60173,8,1112,47657,12516,1.26
 2019,Portage,OH,"Portage, OH",46092,0,1092,46800,-708,0.98
 2020,Portage,OH,"Portage, OH",49221,7,1073,45986,3235,1.07
 2021,Portage,OH,"Portage, OH",51995,6,1038,44486,7509,1.17
 2019,Portage,WI,"Portage, WI",47721,0,952,40800,6921,1.17
 2020,Portage,WI,"Portage, WI",50872,7,1100,47143,3729,1.08
 2021,Portage,WI,"Portage, WI",53435,5,1414,60600,-7165,0.88
 2019,Porter,IN,"Porter, IN",54443,0,1399,59957,-5514,0.91
 2020,Porter,IN,"Porter, IN",56975,5,1434,61457,-4482,0.93
 2021,Porter,IN,"Porter, IN",61250,8,1814,77743,-16493,0.79
 2019,Posey,IN,"Posey, IN",51402,0,781,33471,17931,1.54
 2020,Posey,IN,"Posey, IN",55295,8,855,36643,18652,1.51
 2021,Posey,IN,"Posey, IN",59105,7,794,34029,25076,1.74
 2019,Pottawatomie,KS,"Pottawatomie, KS",53487,0,1176,50400,3087,1.06
 2020,Pottawatomie,KS,"Pottawatomie, KS",57035,7,1014,43457,13578,1.31
 2021,Pottawatomie,KS,"Pottawatomie, KS",59324,4,1466,62829,-3505,0.94
 2019,Pottawatomie,OK,"Pottawatomie, OK",40419,0,701,30043,10376,1.35
 2020,Pottawatomie,OK,"Pottawatomie, OK",42897,6,844,36171,6726,1.19
 2021,Pottawatomie,OK,"Pottawatomie, OK",46730,9,1074,46029,701,1.02
 2019,Pottawattamie,IA,"Pottawattamie, IA",45147,0,840,36000,9147,1.25
 2020,Pottawattamie,IA,"Pottawattamie, IA",47935,6,846,36257,11678,1.32
 2021,Pottawattamie,IA,"Pottawattamie, IA",51370,7,691,29614,21756,1.73
 2019,Potter,PA,"Potter, PA",45232,0,519,22243,22989,2.03
 2020,Potter,PA,"Potter, PA",47845,6,553,23700,24145,2.02
 2021,Potter,PA,"Potter, PA",51432,8,792,33943,17489,1.52
 2019,Potter,SD,"Potter, SD",68426,0,519,22243,46183,3.08
 2020,Potter,SD,"Potter, SD",81156,19,431,18471,62685,4.39
 2021,Potter,SD,"Potter, SD",87031,7,6823,292414,-205383,0.3
 2019,Potter,TX,"Potter, TX",47392,0,825,35357,12035,1.34
 2020,Potter,TX,"Potter, TX",51883,10,1001,42900,8983,1.21
 2021,Potter,TX,"Potter, TX",55764,8,1325,56786,-1022,0.98
 2019,Powder River,MT,"Powder River, MT",34282,0,2832,121371,-87089,0.28
 2020,Powder River,MT,"Powder River, MT",40773,19,2974,127457,-86684,0.32
 2021,Powder River,MT,"Powder River, MT",39838,-2,2638,113057,-73219,0.35
 2019,Powell,KY,"Powell, KY",30680,0,640,27429,3251,1.12
 2020,Powell,KY,"Powell, KY",34947,14,558,23914,11033,1.46
 2021,Powell,KY,"Powell, KY",37993,9,752,32229,5764,1.18
 2019,Powell,MT,"Powell, MT",45601,0,1010,43286,2315,1.05
 2020,Powell,MT,"Powell, MT",49055,8,1033,44271,4784,1.11
 2021,Powell,MT,"Powell, MT",50932,4,1383,59271,-8339,0.86
 2019,Power,ID,"Power, ID",40640,0,809,34671,5969,1.17
 2020,Power,ID,"Power, ID",44237,9,839,35957,8280,1.23
 2021,Power,ID,"Power, ID",43031,-3,1526,65400,-22369,0.66
 2019,Poweshiek,IA,"Poweshiek, IA",45330,0,818,35057,10273,1.29
 2020,Poweshiek,IA,"Poweshiek, IA",49442,9,824,35314,14128,1.4
 2021,Poweshiek,IA,"Poweshiek, IA",53996,9,982,42086,11910,1.28
 2019,Powhatan,VA,"Powhatan, VA",61060,0,1906,81686,-20626,0.75
 2020,Powhatan,VA,"Powhatan, VA",63724,4,2155,92357,-28633,0.69
 2021,Powhatan,VA,"Powhatan, VA",67031,5,2700,115714,-48683,0.58
 2019,Prairie,AR,"Prairie, AR",35328,0,472,20229,15099,1.75
 2020,Prairie,AR,"Prairie, AR",42026,19,631,27043,14983,1.55
 2021,Prairie,AR,"Prairie, AR",43835,4,378,16200,27635,2.71
 2019,Prairie,MT,"Prairie, MT",47082,0,391,16757,30325,2.81
 2020,Prairie,MT,"Prairie, MT",54058,15,485,20786,33272,2.6
 2021,Prairie,MT,"Prairie, MT",49204,-9,646,27686,21518,1.78
 2019,Pratt,KS,"Pratt, KS",48718,0,414,17743,30975,2.75
 2020,Pratt,KS,"Pratt, KS",53421,10,462,19800,33621,2.7
 2021,Pratt,KS,"Pratt, KS",58092,9,565,24214,33878,2.4
 2019,Preble,OH,"Preble, OH",41128,0,673,28843,12285,1.43
 2020,Preble,OH,"Preble, OH",45111,10,691,29614,15497,1.52
 2021,Preble,OH,"Preble, OH",48600,8,775,33214,15386,1.46
 2019,Prentiss,MS,"Prentiss, MS",32094,0,590,25286,6808,1.27
 2020,Prentiss,MS,"Prentiss, MS",34953,9,625,26786,8167,1.3
 2021,Prentiss,MS,"Prentiss, MS",37701,8,981,42043,-4342,0.9
 2019,Presidio,TX,"Presidio, TX",50154,0,1596,68400,-18246,0.73
 2020,Presidio,TX,"Presidio, TX",55514,11,1545,66214,-10700,0.84
 2021,Presidio,TX,"Presidio, TX",61776,11,2006,85971,-24195,0.72
 2019,Presque Isle,MI,"Presque Isle, MI",40274,0,702,30086,10188,1.34
 2020,Presque Isle,MI,"Presque Isle, MI",44888,12,702,30086,14802,1.49
 2021,Presque Isle,MI,"Presque Isle, MI",47138,5,1156,49543,-2405,0.95
 2019,Preston,WV,"Preston, WV",37367,0,786,33686,3681,1.11
 2020,Preston,WV,"Preston, WV",39956,7,764,32743,7213,1.22
 2021,Preston,WV,"Preston, WV",42091,5,860,36857,5234,1.14
 2019,Price,WI,"Price, WI",45085,0,580,24857,20228,1.81
 2020,Price,WI,"Price, WI",48014,7,577,24729,23285,1.94
 2021,Price,WI,"Price, WI",51148,7,735,31500,19648,1.62
 2019,Prince Edward,VA,"Prince Edward, VA",33504,0,818,35057,-1553,0.96
 2020,Prince Edward,VA,"Prince Edward, VA",36074,8,1046,44829,-8755,0.8
 2021,Prince Edward,VA,"Prince Edward, VA",38883,8,1278,54771,-15888,0.71
 2019,Prince George's,MD,"Prince George's, MD",47269,0,1568,67200,-19931,0.7
 2020,Prince George's,MD,"Prince George's, MD",51300,9,1654,70886,-19586,0.72
 2021,Prince George's,MD,"Prince George's, MD",54916,7,1890,81000,-26084,0.68
 2019,Prince Of Wales-hyder,AK,"Prince Of Wales-hyder, AK",49876,0,981,42043,7833,1.19
 2020,Prince Of Wales-hyder,AK,"Prince Of Wales-hyder, AK",51123,3,1237,53014,-1891,0.96
 2021,Prince Of Wales-hyder,AK,"Prince Of Wales-hyder, AK",53266,4,2198,94200,-40934,0.57
 2019,Providence,RI,"Providence, RI",48251,0,1329,56957,-8706,0.85
 2020,Providence,RI,"Providence, RI",52324,8,1380,59143,-6819,0.88
 2021,Providence,RI,"Providence, RI",56429,8,1478,63343,-6914,0.89
 2019,Prowers,CO,"Prowers, CO",39677,0,554,23743,15934,1.67
 2020,Prowers,CO,"Prowers, CO",41752,5,641,27471,14281,1.52
 2021,Prowers,CO,"Prowers, CO",46073,10,908,38914,7159,1.18
 2019,Pueblo,CO,"Pueblo, CO",39857,0,1189,50957,-11100,0.78
 2020,Pueblo,CO,"Pueblo, CO",43513,9,1306,55971,-12458,0.78
 2021,Pueblo,CO,"Pueblo, CO",46927,8,1641,70329,-23402,0.67
 2019,Pulaski,AR,"Pulaski, AR",52047,0,899,38529,13518,1.35
 2020,Pulaski,AR,"Pulaski, AR",55423,7,1003,42986,12437,1.29
 2021,Pulaski,AR,"Pulaski, AR",58583,6,1068,45771,12812,1.28
 2019,Pulaski,GA,"Pulaski, GA",34834,0,669,28671,6163,1.21
 2020,Pulaski,GA,"Pulaski, GA",37589,8,757,32443,5146,1.16
 2021,Pulaski,GA,"Pulaski, GA",40100,7,937,40157,-57,1
 2019,Pulaski,IL,"Pulaski, IL",38088,0,310,13286,24802,2.87
 2020,Pulaski,IL,"Pulaski, IL",43077,13,295,12643,30434,3.41
 2021,Pulaski,IL,"Pulaski, IL",48561,13,287,12300,36261,3.95
 2019,Pulaski,IN,"Pulaski, IN",44616,0,545,23357,21259,1.91
 2020,Pulaski,IN,"Pulaski, IN",49878,12,473,20271,29607,2.46
 2021,Pulaski,IN,"Pulaski, IN",54133,9,830,35571,18562,1.52
 2019,Pulaski,KY,"Pulaski, KY",38839,0,816,34971,3868,1.11
 2020,Pulaski,KY,"Pulaski, KY",42524,10,893,38271,4253,1.11
 2021,Pulaski,KY,"Pulaski, KY",46607,10,1222,52371,-5764,0.89
 2019,Pulaski,MO,"Pulaski, MO",41300,0,717,30729,10571,1.34
 2020,Pulaski,MO,"Pulaski, MO",43973,7,733,31414,12559,1.4
 2021,Pulaski,MO,"Pulaski, MO",44759,2,830,35571,9188,1.26
 2019,Pulaski,VA,"Pulaski, VA",39965,0,842,36086,3879,1.11
 2020,Pulaski,VA,"Pulaski, VA",43597,9,833,35700,7897,1.22
 2021,Pulaski,VA,"Pulaski, VA",47174,8,947,40586,6588,1.16
 2019,Pushmataha,OK,"Pushmataha, OK",32855,0,523,22414,10441,1.47
 2020,Pushmataha,OK,"Pushmataha, OK",35987,10,642,27514,8473,1.31
 2021,Pushmataha,OK,"Pushmataha, OK",39442,10,943,40414,-972,0.98
 2019,Putnam,FL,"Putnam, FL",34224,0,959,41100,-6876,0.83
 2020,Putnam,FL,"Putnam, FL",37129,9,1018,43629,-6500,0.85
 2021,Putnam,FL,"Putnam, FL",40376,9,1237,53014,-12638,0.76
 2019,Putnam,GA,"Putnam, GA",45971,0,1600,68571,-22600,0.67
 2020,Putnam,GA,"Putnam, GA",49574,8,1717,73586,-24012,0.67
 2021,Putnam,GA,"Putnam, GA",53019,7,2289,98100,-45081,0.54
 2019,Putnam,IL,"Putnam, IL",64855,0,749,32100,32755,2.02
 2020,Putnam,IL,"Putnam, IL",66005,2,907,38871,27134,1.7
 2021,Putnam,IL,"Putnam, IL",74073,12,874,37457,36616,1.98
 2019,Putnam,IN,"Putnam, IN",39329,0,791,33900,5429,1.16
 2020,Putnam,IN,"Putnam, IN",42380,8,837,35871,6509,1.18
 2021,Putnam,IN,"Putnam, IN",45681,8,1169,50100,-4419,0.91
 2019,Putnam,MO,"Putnam, MO",36103,0,353,15129,20974,2.39
 2020,Putnam,MO,"Putnam, MO",39446,9,429,18386,21060,2.15
 2021,Putnam,MO,"Putnam, MO",41629,6,1351,57900,-16271,0.72
 2019,Putnam,NY,"Putnam, NY",70345,0,2044,87600,-17255,0.8
 2020,Putnam,NY,"Putnam, NY",74127,5,1914,82029,-7902,0.9
 2021,Putnam,NY,"Putnam, NY",78754,6,2394,102600,-23846,0.77
 2019,Putnam,OH,"Putnam, OH",49854,0,560,24000,25854,2.08
 2020,Putnam,OH,"Putnam, OH",53906,8,606,25971,27935,2.08
 2021,Putnam,OH,"Putnam, OH",57868,7,865,37071,20797,1.56
 2019,Putnam,TN,"Putnam, TN",41621,0,1234,52886,-11265,0.79
 2020,Putnam,TN,"Putnam, TN",44512,7,1274,54600,-10088,0.82
 2021,Putnam,TN,"Putnam, TN",47536,7,1884,80743,-33207,0.59
 2019,Putnam,WV,"Putnam, WV",48218,0,1117,47871,347,1.01
 2020,Putnam,WV,"Putnam, WV",50355,4,1025,43929,6426,1.15
 2021,Putnam,WV,"Putnam, WV",53536,6,1120,48000,5536,1.12
 2019,Quay,NM,"Quay, NM",37684,0,368,15771,21913,2.39
 2020,Quay,NM,"Quay, NM",41017,9,412,17657,23360,2.32
 2021,Quay,NM,"Quay, NM",44798,9,1119,47957,-3159,0.93
 2019,Queen Anne's,MD,"Queen Anne's, MD",68447,0,1853,79414,-10967,0.86
 2020,Queen Anne's,MD,"Queen Anne's, MD",71470,4,2145,91929,-20459,0.78
 2021,Queen Anne's,MD,"Queen Anne's, MD",75811,6,2212,94800,-18989,0.8
 2019,Queens,NY,"Queens, NY",48675,0,2822,120943,-72268,0.4
 2020,Queens,NY,"Queens, NY",53838,11,2843,121843,-68005,0.44
 2021,Queens,NY,"Queens, NY",58646,9,2596,111257,-52611,0.53
 2019,Quitman,GA,"Quitman, GA",33132,0,652,27943,5189,1.19
 2020,Quitman,GA,"Quitman, GA",36692,11,743,31843,4849,1.15
 2021,Quitman,GA,"Quitman, GA",38398,5,2155,92357,-53959,0.42
 2019,Quitman,MS,"Quitman, MS",31506,0,471,20186,11320,1.56
 2020,Quitman,MS,"Quitman, MS",36525,16,371,15900,20625,2.3
 2021,Quitman,MS,"Quitman, MS",41682,14,1327,56871,-15189,0.73
 2019,Rabun,GA,"Rabun, GA",43631,0,1790,76714,-33083,0.57
 2020,Rabun,GA,"Rabun, GA",47292,8,1945,83357,-36065,0.57
 2021,Rabun,GA,"Rabun, GA",50488,7,1796,76971,-26483,0.66
 2019,Racine,WI,"Racine, WI",50274,0,1050,45000,5274,1.12
 2020,Racine,WI,"Racine, WI",53005,5,1047,44871,8134,1.18
 2021,Racine,WI,"Racine, WI",56884,7,1143,48986,7898,1.16
 2019,Rains,TX,"Rains, TX",36781,0,1030,44143,-7362,0.83
 2020,Rains,TX,"Rains, TX",38962,6,939,40243,-1281,0.97
 2021,Rains,TX,"Rains, TX",41563,7,1095,46929,-5366,0.89
 2019,Raleigh,WV,"Raleigh, WV",42917,0,665,28500,14417,1.51
 2020,Raleigh,WV,"Raleigh, WV",43888,2,658,28200,15688,1.56
 2021,Raleigh,WV,"Raleigh, WV",47265,8,683,29271,17994,1.61
 2019,Ralls,MO,"Ralls, MO",40326,0,771,33043,7283,1.22
 2020,Ralls,MO,"Ralls, MO",44503,10,1122,48086,-3583,0.93
 2021,Ralls,MO,"Ralls, MO",47714,7,1431,61329,-13615,0.78
 2019,Ramsey,MN,"Ramsey, MN",54587,0,1371,58757,-4170,0.93
 2020,Ramsey,MN,"Ramsey, MN",58217,7,1327,56871,1346,1.02
 2021,Ramsey,MN,"Ramsey, MN",62594,8,1275,54643,7951,1.15
 2019,Ramsey,ND,"Ramsey, ND",49856,0,805,34500,15356,1.45
 2020,Ramsey,ND,"Ramsey, ND",56950,14,1049,44957,11993,1.27
 2021,Ramsey,ND,"Ramsey, ND",59490,5,807,34586,24904,1.72
 2019,Rankin,MS,"Rankin, MS",45496,0,1207,51729,-6233,0.88
 2020,Rankin,MS,"Rankin, MS",48595,7,1303,55843,-7248,0.87
 2021,Rankin,MS,"Rankin, MS",51235,5,1798,77057,-25822,0.66
 2019,Ransom,ND,"Ransom, ND",54832,0,431,18471,36361,2.97
 2020,Ransom,ND,"Ransom, ND",60122,10,560,24000,36122,2.51
 2021,Ransom,ND,"Ransom, ND",64827,8,594,25457,39370,2.55
 2019,Rapides,LA,"Rapides, LA",46088,0,899,38529,7559,1.2
 2020,Rapides,LA,"Rapides, LA",50556,10,902,38657,11899,1.31
 2021,Rapides,LA,"Rapides, LA",54153,7,984,42171,11982,1.28
 2019,Rappahannock,VA,"Rappahannock, VA",69525,0,2414,103457,-33932,0.67
 2020,Rappahannock,VA,"Rappahannock, VA",72056,4,2850,122143,-50087,0.59
 2021,Rappahannock,VA,"Rappahannock, VA",76181,6,5454,233743,-157562,0.33
 2019,Ravalli,MT,"Ravalli, MT",50072,0,2118,90771,-40699,0.55
 2020,Ravalli,MT,"Ravalli, MT",53310,7,2396,102686,-49376,0.52
 2021,Ravalli,MT,"Ravalli, MT",56321,6,4041,173186,-116865,0.33
 2019,Rawlins,KS,"Rawlins, KS",56351,0,841,36043,20308,1.56
 2020,Rawlins,KS,"Rawlins, KS",69786,24,601,25757,44029,2.71
 2021,Rawlins,KS,"Rawlins, KS",80389,15,422,18086,62303,4.44
 2019,Ray,MO,"Ray, MO",42782,0,649,27814,14968,1.54
 2020,Ray,MO,"Ray, MO",45644,7,876,37543,8101,1.22
 2021,Ray,MO,"Ray, MO",48843,7,838,35914,12929,1.36
 2019,Reagan,TX,"Reagan, TX",58618,0,266,11400,47218,5.14
 2020,Reagan,TX,"Reagan, TX",56424,-4,897,38443,17981,1.47
 2021,Reagan,TX,"Reagan, TX",61077,8,659,28243,32834,2.16
 2019,Real,TX,"Real, TX",46008,0,1138,48771,-2763,0.94
 2020,Real,TX,"Real, TX",52249,14,1371,58757,-6508,0.89
 2021,Real,TX,"Real, TX",55449,6,2202,94371,-38922,0.59
 2019,Red Lake,MN,"Red Lake, MN",49604,0,581,24900,24704,1.99
 2020,Red Lake,MN,"Red Lake, MN",57090,15,704,30171,26919,1.89
 2021,Red Lake,MN,"Red Lake, MN",65147,14,967,41443,23704,1.57
 2019,Red River,LA,"Red River, LA",46244,0,708,30343,15901,1.52
 2020,Red River,LA,"Red River, LA",50003,8,514,22029,27974,2.27
 2021,Red River,LA,"Red River, LA",54964,10,995,42643,12321,1.29
 2019,Red River,TX,"Red River, TX",45699,0,472,20229,25470,2.26
 2020,Red River,TX,"Red River, TX",49198,8,651,27900,21298,1.76
 2021,Red River,TX,"Red River, TX",53818,9,722,30943,22875,1.74
 2019,Red Willow,NE,"Red Willow, NE",46784,0,602,25800,20984,1.81
 2020,Red Willow,NE,"Red Willow, NE",51790,11,706,30257,21533,1.71
 2021,Red Willow,NE,"Red Willow, NE",53974,4,699,29957,24017,1.8
 2019,Redwood,MN,"Redwood, MN",52951,0,405,17357,35594,3.05
 2020,Redwood,MN,"Redwood, MN",60667,15,512,21943,38724,2.76
 2021,Redwood,MN,"Redwood, MN",63700,5,703,30129,33571,2.11
 2019,Reeves,TX,"Reeves, TX",51257,0,743,31843,19414,1.61
 2020,Reeves,TX,"Reeves, TX",48054,-6,1096,46971,1083,1.02
 2021,Reeves,TX,"Reeves, TX",52811,10,1331,57043,-4232,0.93
 2019,Refugio,TX,"Refugio, TX",47999,0,927,39729,8270,1.21
 2020,Refugio,TX,"Refugio, TX",49471,3,717,30729,18742,1.61
 2021,Refugio,TX,"Refugio, TX",54475,10,903,38700,15775,1.41
 2019,Reno,KS,"Reno, KS",41805,0,507,21729,20076,1.92
 2020,Reno,KS,"Reno, KS",45089,8,490,21000,24089,2.15
 2021,Reno,KS,"Reno, KS",47918,6,462,19800,28118,2.42
 2019,Rensselaer,NY,"Rensselaer, NY",50039,0,1108,47486,2553,1.05
 2020,Rensselaer,NY,"Rensselaer, NY",54643,9,1169,50100,4543,1.09
 2021,Rensselaer,NY,"Rensselaer, NY",58126,6,1297,55586,2540,1.05
 2019,Renville,MN,"Renville, MN",47453,0,574,24600,22853,1.93
 2020,Renville,MN,"Renville, MN",56369,19,453,19414,36955,2.9
 2021,Renville,MN,"Renville, MN",61406,9,719,30814,30592,1.99
 2019,Renville,ND,"Renville, ND",69861,0,338,14486,55375,4.82
 2020,Renville,ND,"Renville, ND",79383,14,443,18986,60397,4.18
 2021,Renville,ND,"Renville, ND",78282,-1,524,22457,55825,3.49
 2019,Republic,KS,"Republic, KS",42880,0,187,8014,34866,5.35
 2020,Republic,KS,"Republic, KS",47678,11,736,31543,16135,1.51
 2021,Republic,KS,"Republic, KS",49342,4,595,25500,23842,1.93
 2019,Reynolds,MO,"Reynolds, MO",36189,0,736,31543,4646,1.15
 2020,Reynolds,MO,"Reynolds, MO",40045,11,743,31843,8202,1.26
 2021,Reynolds,MO,"Reynolds, MO",43066,8,1087,46586,-3520,0.92
 2019,Rhea,TN,"Rhea, TN",36163,0,1100,47143,-10980,0.77
 2020,Rhea,TN,"Rhea, TN",39571,9,1087,46586,-7015,0.85
 2021,Rhea,TN,"Rhea, TN",42174,7,1337,57300,-15126,0.74
 2019,Rice,KS,"Rice, KS",43831,0,443,18986,24845,2.31
 2020,Rice,KS,"Rice, KS",46852,7,329,14100,32752,3.32
 2021,Rice,KS,"Rice, KS",47894,2,713,30557,17337,1.57
 2019,Rice,MN,"Rice, MN",45230,0,1457,62443,-17213,0.72
 2020,Rice,MN,"Rice, MN",48412,7,1450,62143,-13731,0.78
 2021,Rice,MN,"Rice, MN",51545,7,1687,72300,-20755,0.71
 2019,Rich,UT,"Rich, UT",39231,0,1422,60943,-21712,0.64
 2020,Rich,UT,"Rich, UT",41668,6,1688,72343,-30675,0.58
 2021,Rich,UT,"Rich, UT",43280,4,3618,155057,-111777,0.28
 2019,Richardson,NE,"Richardson, NE",49797,0,407,17443,32354,2.85
 2020,Richardson,NE,"Richardson, NE",54936,10,399,17100,37836,3.21
 2021,Richardson,NE,"Richardson, NE",60001,9,490,21000,39001,2.86
 2019,Richmond,GA,"Richmond, GA",38085,0,591,25329,12756,1.5
 2020,Richmond,GA,"Richmond, GA",41051,8,675,28929,12122,1.42
 2021,Richmond,GA,"Richmond, GA",43429,6,811,34757,8672,1.25
 2019,Richmond,NC,"Richmond, NC",36629,0,576,24686,11943,1.48
 2020,Richmond,NC,"Richmond, NC",40055,9,500,21429,18626,1.87
 2021,Richmond,NC,"Richmond, NC",44562,11,769,32957,11605,1.35
 2019,Richmond,NY,"Richmond, NY",56475,0,2854,122314,-65839,0.46
 2020,Richmond,NY,"Richmond, NY",60381,7,2873,123129,-62748,0.49
 2021,Richmond,NY,"Richmond, NY",65113,8,2927,125443,-60330,0.52
 2019,Richmond,VA,"Richmond, VA",38119,0,991,42471,-4352,0.9
 2020,Richmond,VA,"Richmond, VA",42137,11,1107,47443,-5306,0.89
 2021,Richmond,VA,"Richmond, VA",44749,6,1307,56014,-11265,0.8
 2019,Riley,KS,"Riley, KS",43570,0,956,40971,2599,1.06
 2020,Riley,KS,"Riley, KS",46108,6,943,40414,5694,1.14
 2021,Riley,KS,"Riley, KS",47764,4,995,42643,5121,1.12
 2019,Ringgold,IA,"Ringgold, IA",48483,0,791,33900,14583,1.43
 2020,Ringgold,IA,"Ringgold, IA",51565,6,902,38657,12908,1.33
 2021,Ringgold,IA,"Ringgold, IA",57317,11,813,34843,22474,1.65
 2019,Rio Arriba,NM,"Rio Arriba, NM",34872,0,1338,57343,-22471,0.61
 2020,Rio Arriba,NM,"Rio Arriba, NM",38992,12,1338,57343,-18351,0.68
 2021,Rio Arriba,NM,"Rio Arriba, NM",42467,9,2552,109371,-66904,0.39
 2019,Rio Blanco,CO,"Rio Blanco, CO",47144,0,875,37500,9644,1.26
 2020,Rio Blanco,CO,"Rio Blanco, CO",50197,7,1010,43286,6911,1.16
 2021,Rio Blanco,CO,"Rio Blanco, CO",54745,9,1254,53743,1002,1.02
 2019,Ripley,IN,"Ripley, IN",42128,0,829,35529,6599,1.19
 2020,Ripley,IN,"Ripley, IN",45942,9,772,33086,12856,1.39
 2021,Ripley,IN,"Ripley, IN",49158,7,833,35700,13458,1.38
 2019,Ripley,MO,"Ripley, MO",37947,0,559,23957,13990,1.58
 2020,Ripley,MO,"Ripley, MO",42565,12,500,21429,21136,1.99
 2021,Ripley,MO,"Ripley, MO",45666,7,692,29657,16009,1.54
 2019,Ritchie,WV,"Ritchie, WV",45010,0,516,22114,22896,2.04
 2020,Ritchie,WV,"Ritchie, WV",48184,7,678,29057,19127,1.66
 2021,Ritchie,WV,"Ritchie, WV",52040,8,1480,63429,-11389,0.82
 2019,Riverside,CA,"Riverside, CA",43295,0,2066,88543,-45248,0.49
 2020,Riverside,CA,"Riverside, CA",47702,10,2143,91843,-44141,0.52
 2021,Riverside,CA,"Riverside, CA",51180,7,2837,121586,-70406,0.42
 2019,Roane,TN,"Roane, TN",43488,0,1096,46971,-3483,0.93
 2020,Roane,TN,"Roane, TN",46373,7,1289,55243,-8870,0.84
 2021,Roane,TN,"Roane, TN",49972,8,1110,47571,2401,1.05
 2019,Roane,WV,"Roane, WV",34699,0,641,27471,7228,1.26
 2020,Roane,WV,"Roane, WV",37521,8,644,27600,9921,1.36
 2021,Roane,WV,"Roane, WV",39963,7,605,25929,14034,1.54
 2019,Roanoke,VA,"Roanoke, VA",42079,0,1173,50271,-8192,0.84
 2020,Roanoke,VA,"Roanoke, VA",46550,11,1287,55157,-8607,0.84
 2021,Roanoke,VA,"Roanoke, VA",50599,9,1429,61243,-10644,0.83
 2019,Roberts,SD,"Roberts, SD",37764,0,792,33943,3821,1.11
 2020,Roberts,SD,"Roberts, SD",46077,22,574,24600,21477,1.87
 2021,Roberts,SD,"Roberts, SD",50205,9,1195,51214,-1009,0.98
 2019,Roberts,TX,"Roberts, TX",50589,0,454,19457,31132,2.6
 2020,Roberts,TX,"Roberts, TX",53413,6,1001,42900,10513,1.25
 2021,Roberts,TX,"Roberts, TX",56868,7,695,29786,27082,1.91
 2019,Robertson,KY,"Robertson, KY",33465,0,701,30043,3422,1.11
 2020,Robertson,KY,"Robertson, KY",38772,16,638,27343,11429,1.42
 2021,Robertson,KY,"Robertson, KY",41155,6,719,30814,10341,1.34
 2019,Robertson,TN,"Robertson, TN",44306,0,1368,58629,-14323,0.76
 2020,Robertson,TN,"Robertson, TN",46519,5,1422,60943,-14424,0.76
 2021,Robertson,TN,"Robertson, TN",51097,10,1857,79586,-28489,0.64
 2019,Robertson,TX,"Robertson, TX",44992,0,1063,45557,-565,0.99
 2020,Robertson,TX,"Robertson, TX",47569,6,1246,53400,-5831,0.89
 2021,Robertson,TX,"Robertson, TX",52894,11,1299,55671,-2777,0.95
 2019,Robeson,NC,"Robeson, NC",33639,0,553,23700,9939,1.42
 2020,Robeson,NC,"Robeson, NC",36880,10,552,23657,13223,1.56
 2021,Robeson,NC,"Robeson, NC",41780,13,807,34586,7194,1.21
 2019,Rock,MN,"Rock, MN",48827,0,902,38657,10170,1.26
 2020,Rock,MN,"Rock, MN",56690,16,687,29443,27247,1.93
 2021,Rock,MN,"Rock, MN",57744,2,833,35700,22044,1.62
 2019,Rock,NE,"Rock, NE",64946,0,486,20829,44117,3.12
 2020,Rock,NE,"Rock, NE",76670,18,420,18000,58670,4.26
 2021,Rock,NE,"Rock, NE",80527,5,366,15686,64841,5.13
 2019,Rock,WI,"Rock, WI",45883,0,944,40457,5426,1.13
 2020,Rock,WI,"Rock, WI",49129,7,1022,43800,5329,1.12
 2021,Rock,WI,"Rock, WI",52787,7,1129,48386,4401,1.09
 2019,Rockcastle,KY,"Rockcastle, KY",33647,0,653,27986,5661,1.2
 2020,Rockcastle,KY,"Rockcastle, KY",37428,11,783,33557,3871,1.12
 2021,Rockcastle,KY,"Rockcastle, KY",41290,10,835,35786,5504,1.15
 2019,Rockdale,GA,"Rockdale, GA",35602,0,990,42429,-6827,0.84
 2020,Rockdale,GA,"Rockdale, GA",39358,11,1189,50957,-11599,0.77
 2021,Rockdale,GA,"Rockdale, GA",43042,9,1543,66129,-23087,0.65
 2019,Rockingham,NC,"Rockingham, NC",38428,0,664,28457,9971,1.35
 2020,Rockingham,NC,"Rockingham, NC",41249,7,743,31843,9406,1.3
 2021,Rockingham,NC,"Rockingham, NC",45049,9,906,38829,6220,1.16
 2019,Rockingham,NH,"Rockingham, NH",79315,0,2146,91971,-12656,0.86
 2020,Rockingham,NH,"Rockingham, NH",82496,4,2322,99514,-17018,0.83
 2021,Rockingham,NH,"Rockingham, NH",88303,7,2725,116786,-28483,0.76
 2019,Rockwall,TX,"Rockwall, TX",65526,0,1704,73029,-7503,0.9
 2020,Rockwall,TX,"Rockwall, TX",66943,2,1705,73071,-6128,0.92
 2021,Rockwall,TX,"Rockwall, TX",70833,6,2201,94329,-23496,0.75
 2019,Roger Mills,OK,"Roger Mills, OK",43864,0,377,16157,27707,2.71
 2020,Roger Mills,OK,"Roger Mills, OK",46890,7,305,13071,33819,3.59
 2021,Roger Mills,OK,"Roger Mills, OK",50590,8,604,25886,24704,1.95
 2019,Rogers,OK,"Rogers, OK",47480,0,1157,49586,-2106,0.96
 2020,Rogers,OK,"Rogers, OK",49464,4,1287,55157,-5693,0.9
 2021,Rogers,OK,"Rogers, OK",52142,5,1431,61329,-9187,0.85
 2019,Rolette,ND,"Rolette, ND",41420,0,518,22200,19220,1.87
 2020,Rolette,ND,"Rolette, ND",48719,18,763,32700,16019,1.49
 2021,Rolette,ND,"Rolette, ND",52939,9,1052,45086,7853,1.17
 2019,Rooks,KS,"Rooks, KS",39050,0,376,16114,22936,2.42
 2020,Rooks,KS,"Rooks, KS",45289,16,414,17743,27546,2.55
 2021,Rooks,KS,"Rooks, KS",49795,10,308,13200,36595,3.77
 2019,Roosevelt,MT,"Roosevelt, MT",36659,0,785,33643,3016,1.09
 2020,Roosevelt,MT,"Roosevelt, MT",40608,11,689,29529,11079,1.38
 2021,Roosevelt,MT,"Roosevelt, MT",43207,6,924,39600,3607,1.09
 2019,Roosevelt,NM,"Roosevelt, NM",39990,0,694,29743,10247,1.34
 2020,Roosevelt,NM,"Roosevelt, NM",43456,9,736,31543,11913,1.38
 2021,Roosevelt,NM,"Roosevelt, NM",45456,5,769,32957,12499,1.38
 2019,Roscommon,MI,"Roscommon, MI",38065,0,581,24900,13165,1.53
 2020,Roscommon,MI,"Roscommon, MI",42721,12,584,25029,17692,1.71
 2021,Roscommon,MI,"Roscommon, MI",44518,4,893,38271,6247,1.16
 2019,Roseau,MN,"Roseau, MN",47177,0,766,32829,14348,1.44
 2020,Roseau,MN,"Roseau, MN",54279,15,707,30300,23979,1.79
 2021,Roseau,MN,"Roseau, MN",60337,11,1144,49029,11308,1.23
 2019,Rosebud,MT,"Rosebud, MT",47753,0,691,29614,18139,1.61
 2020,Rosebud,MT,"Rosebud, MT",52220,9,725,31071,21149,1.68
 2021,Rosebud,MT,"Rosebud, MT",53461,2,596,25543,27918,2.09
 2019,Ross,OH,"Ross, OH",38739,0,641,27471,11268,1.41
 2020,Ross,OH,"Ross, OH",42468,10,734,31457,11011,1.35
 2021,Ross,OH,"Ross, OH",45596,7,811,34757,10839,1.31
 2019,Routt,CO,"Routt, CO",88318,0,3205,137357,-49039,0.64
 2020,Routt,CO,"Routt, CO",94626,7,3617,155014,-60388,0.61
 2021,Routt,CO,"Routt, CO",98371,4,6206,265971,-167600,0.37
 2019,Rowan,KY,"Rowan, KY",31789,0,776,33257,-1468,0.96
 2020,Rowan,KY,"Rowan, KY",34847,10,812,34800,47,1
 2021,Rowan,KY,"Rowan, KY",37769,8,724,31029,6740,1.22
 2019,Rowan,NC,"Rowan, NC",39508,0,961,41186,-1678,0.96
 2020,Rowan,NC,"Rowan, NC",42922,9,999,42814,108,1
 2021,Rowan,NC,"Rowan, NC",46763,9,1240,53143,-6380,0.88
 2019,Runnels,TX,"Runnels, TX",44855,0,477,20443,24412,2.19
 2020,Runnels,TX,"Runnels, TX",46861,5,551,23614,23247,1.98
 2021,Runnels,TX,"Runnels, TX",51307,10,687,29443,21864,1.74
 2019,Rush,IN,"Rush, IN",45821,0,479,20529,25292,2.23
 2020,Rush,IN,"Rush, IN",49214,7,448,19200,30014,2.56
 2021,Rush,IN,"Rush, IN",54210,10,653,27986,26224,1.94
 2019,Rush,KS,"Rush, KS",51318,0,233,9986,41332,5.14
 2020,Rush,KS,"Rush, KS",59414,16,323,13843,45571,4.29
 2021,Rush,KS,"Rush, KS",62819,6,580,24857,37962,2.53
 2019,Rusk,TX,"Rusk, TX",39860,0,877,37586,2274,1.06
 2020,Rusk,TX,"Rusk, TX",41911,5,799,34243,7668,1.22
 2021,Rusk,TX,"Rusk, TX",44874,7,1119,47957,-3083,0.94
 2019,Rusk,WI,"Rusk, WI",44793,0,689,29529,15264,1.52
 2020,Rusk,WI,"Rusk, WI",48208,8,726,31114,17094,1.55
 2021,Rusk,WI,"Rusk, WI",51844,8,909,38957,12887,1.33
 2019,Russell,AL,"Russell, AL",33141,0,699,29957,3184,1.11
 2020,Russell,AL,"Russell, AL",35878,8,778,33343,2535,1.08
 2021,Russell,AL,"Russell, AL",39378,10,836,35829,3549,1.1
 2019,Russell,KS,"Russell, KS",46055,0,462,19800,26255,2.33
 2020,Russell,KS,"Russell, KS",49781,8,489,20957,28824,2.38
 2021,Russell,KS,"Russell, KS",53679,8,324,13886,39793,3.87
 2019,Russell,KY,"Russell, KY",37957,0,731,31329,6628,1.21
 2020,Russell,KY,"Russell, KY",41673,10,728,31200,10473,1.34
 2021,Russell,KY,"Russell, KY",45383,9,1073,45986,-603,0.99
 2019,Russell,VA,"Russell, VA",34512,0,551,23614,10898,1.46
 2020,Russell,VA,"Russell, VA",37141,8,651,27900,9241,1.33
 2021,Russell,VA,"Russell, VA",40061,8,765,32786,7275,1.22
 2019,Rutherford,NC,"Rutherford, NC",35607,0,1436,61543,-25936,0.58
 2020,Rutherford,NC,"Rutherford, NC",38741,9,1424,61029,-22288,0.63
 2021,Rutherford,NC,"Rutherford, NC",42376,9,1659,71100,-28724,0.6
 2019,Rutherford,TN,"Rutherford, TN",43273,0,1564,67029,-23756,0.65
 2020,Rutherford,TN,"Rutherford, TN",45604,5,1556,66686,-21082,0.68
 2021,Rutherford,TN,"Rutherford, TN",49411,8,2009,86100,-36689,0.57
 2019,Sabine,LA,"Sabine, LA",38645,0,1126,48257,-9612,0.8
 2020,Sabine,LA,"Sabine, LA",41254,7,1181,50614,-9360,0.82
 2021,Sabine,LA,"Sabine, LA",45105,9,1466,62829,-17724,0.72
 2019,Sabine,TX,"Sabine, TX",38759,0,890,38143,616,1.02
 2020,Sabine,TX,"Sabine, TX",42290,9,1086,46543,-4253,0.91
 2021,Sabine,TX,"Sabine, TX",44900,6,1071,45900,-1000,0.98
 2019,Sac,IA,"Sac, IA",57210,0,348,14914,42296,3.84
 2020,Sac,IA,"Sac, IA",56444,-1,580,24857,31587,2.27
 2021,Sac,IA,"Sac, IA",65620,16,917,39300,26320,1.67
 2019,Sacramento,CA,"Sacramento, CA",53005,0,1881,80614,-27609,0.66
 2020,Sacramento,CA,"Sacramento, CA",57991,9,2048,87771,-29780,0.66
 2021,Sacramento,CA,"Sacramento, CA",61829,7,2488,106629,-44800,0.58
 2019,Sagadahoc,ME,"Sagadahoc, ME",52027,0,1287,55157,-3130,0.94
 2020,Sagadahoc,ME,"Sagadahoc, ME",56312,8,1698,72771,-16459,0.77
 2021,Sagadahoc,ME,"Sagadahoc, ME",59843,6,2153,92271,-32428,0.65
 2019,Saginaw,MI,"Saginaw, MI",42114,0,574,24600,17514,1.71
 2020,Saginaw,MI,"Saginaw, MI",46419,10,534,22886,23533,2.03
 2021,Saginaw,MI,"Saginaw, MI",49274,6,571,24471,24803,2.01
 2019,Saguache,CO,"Saguache, CO",37140,0,1293,55414,-18274,0.67
 2020,Saguache,CO,"Saguache, CO",38688,4,1396,59829,-21141,0.65
 2021,Saguache,CO,"Saguache, CO",43959,14,1737,74443,-30484,0.59
 2019,Salem,NJ,"Salem, NJ",48860,0,670,28714,20146,1.7
 2020,Salem,NJ,"Salem, NJ",52936,8,669,28671,24265,1.85
 2021,Salem,NJ,"Salem, NJ",57547,9,921,39471,18076,1.46
 2019,Saline,AR,"Saline, AR",43696,0,1066,45686,-1990,0.96
 2020,Saline,AR,"Saline, AR",46269,6,1237,53014,-6745,0.87
 2021,Saline,AR,"Saline, AR",49031,6,1547,66300,-17269,0.74
 2019,Saline,IL,"Saline, IL",39674,0,349,14957,24717,2.65
 2020,Saline,IL,"Saline, IL",43234,9,354,15171,28063,2.85
 2021,Saline,IL,"Saline, IL",47402,10,323,13843,33559,3.42
 2019,Saline,KS,"Saline, KS",51219,0,792,33943,17276,1.51
 2020,Saline,KS,"Saline, KS",53147,4,739,31671,21476,1.68
 2021,Saline,KS,"Saline, KS",56258,6,587,25157,31101,2.24
 2019,Saline,MO,"Saline, MO",37351,0,530,22714,14637,1.64
 2020,Saline,MO,"Saline, MO",41697,12,627,26871,14826,1.55
 2021,Saline,MO,"Saline, MO",44067,6,655,28071,15996,1.57
 2019,Saline,NE,"Saline, NE",42769,0,715,30643,12126,1.4
 2020,Saline,NE,"Saline, NE",46753,9,742,31800,14953,1.47
 2021,Saline,NE,"Saline, NE",51623,10,815,34929,16694,1.48
 2019,Salt Lake,UT,"Salt Lake, UT",53472,0,2044,87600,-34128,0.61
 2020,Salt Lake,UT,"Salt Lake, UT",58028,9,2332,99943,-41915,0.58
 2021,Salt Lake,UT,"Salt Lake, UT",62547,8,2716,116400,-53853,0.54
 2019,Saluda,SC,"Saluda, SC",37994,0,1123,48129,-10135,0.79
 2020,Saluda,SC,"Saluda, SC",40423,6,1631,69900,-29477,0.58
 2021,Saluda,SC,"Saluda, SC",44503,10,1665,71357,-26854,0.62
 2019,Sampson,NC,"Sampson, NC",37994,0,762,32657,5337,1.16
 2020,Sampson,NC,"Sampson, NC",40646,7,887,38014,2632,1.07
 2021,Sampson,NC,"Sampson, NC",45841,13,1201,51471,-5630,0.89
 2019,San Augustine,TX,"San Augustine, TX",45260,0,853,36557,8703,1.24
 2020,San Augustine,TX,"San Augustine, TX",45510,1,760,32571,12939,1.4
 2021,San Augustine,TX,"San Augustine, TX",50573,11,1292,55371,-4798,0.91
 2019,San Benito,CA,"San Benito, CA",54370,0,2968,127200,-72830,0.43
 2020,San Benito,CA,"San Benito, CA",61564,13,3251,139329,-77765,0.44
 2021,San Benito,CA,"San Benito, CA",68868,12,4047,173443,-104575,0.4
 2019,San Bernardino,CA,"San Bernardino, CA",41253,0,1685,72214,-30961,0.57
 2020,San Bernardino,CA,"San Bernardino, CA",45499,10,1763,75557,-30058,0.6
 2021,San Bernardino,CA,"San Bernardino, CA",49493,9,2340,100286,-50793,0.49
 2019,San Diego,CA,"San Diego, CA",62533,0,3219,137957,-75424,0.45
 2020,San Diego,CA,"San Diego, CA",67830,9,3495,149786,-81956,0.45
 2021,San Diego,CA,"San Diego, CA",72637,7,3968,170057,-97420,0.43
 2019,San Francisco,CA,"San Francisco, CA",130464,0,6635,284357,-153893,0.46
 2020,San Francisco,CA,"San Francisco, CA",141134,8,7340,314571,-173437,0.45
 2021,San Francisco,CA,"San Francisco, CA",160749,14,6242,267514,-106765,0.6
 2019,San Jacinto,TX,"San Jacinto, TX",41707,0,971,41614,93,1
 2020,San Jacinto,TX,"San Jacinto, TX",43626,5,954,40886,2740,1.07
 2021,San Jacinto,TX,"San Jacinto, TX",46477,7,1186,50829,-4352,0.91
 2019,San Joaquin,CA,"San Joaquin, CA",45547,0,1864,79886,-34339,0.57
 2020,San Joaquin,CA,"San Joaquin, CA",51766,14,2058,88200,-36434,0.59
 2021,San Joaquin,CA,"San Joaquin, CA",57783,12,2593,111129,-53346,0.52
 2019,San Juan,CO,"San Juan, CO",49887,0,1663,71271,-21384,0.7
 2020,San Juan,CO,"San Juan, CO",53827,8,1642,70371,-16544,0.76
 2021,San Juan,CO,"San Juan, CO",58067,8,4335,185786,-127719,0.31
 2019,San Juan,NM,"San Juan, NM",36599,0,1024,43886,-7287,0.83
 2020,San Juan,NM,"San Juan, NM",38835,6,1007,43157,-4322,0.9
 2021,San Juan,NM,"San Juan, NM",41735,8,1239,53100,-11365,0.79
 2019,San Juan,UT,"San Juan, UT",29299,0,1699,72814,-43515,0.4
 2020,San Juan,UT,"San Juan, UT",32289,10,1487,63729,-31440,0.51
 2021,San Juan,UT,"San Juan, UT",34038,5,1693,72557,-38519,0.47
 2019,San Juan,WA,"San Juan, WA",81070,0,3813,163414,-82344,0.5
 2020,San Juan,WA,"San Juan, WA",84496,4,3634,155743,-71247,0.54
 2021,San Juan,WA,"San Juan, WA",87038,3,5746,246257,-159219,0.35
 2019,San Luis Obispo,CA,"San Luis Obispo, CA",59806,0,3354,143743,-83937,0.42
 2020,San Luis Obispo,CA,"San Luis Obispo, CA",63652,6,3566,152829,-89177,0.42
 2021,San Luis Obispo,CA,"San Luis Obispo, CA",66617,5,4031,172757,-106140,0.39
 2019,San Mateo,CA,"San Mateo, CA",131180,0,7065,302786,-171606,0.43
 2020,San Mateo,CA,"San Mateo, CA",142264,8,7987,342300,-200036,0.42
 2021,San Mateo,CA,"San Mateo, CA",160485,13,7048,302057,-141572,0.53
 2019,San Miguel,CO,"San Miguel, CO",95927,0,9531,408471,-312544,0.23
 2020,San Miguel,CO,"San Miguel, CO",101654,6,8747,374871,-273217,0.27
 2021,San Miguel,CO,"San Miguel, CO",109613,8,20381,873471,-763858,0.13
 2019,San Miguel,NM,"San Miguel, NM",36646,0,1098,47057,-10411,0.78
 2020,San Miguel,NM,"San Miguel, NM",41194,12,1090,46714,-5520,0.88
 2021,San Miguel,NM,"San Miguel, NM",44889,9,1228,52629,-7740,0.85
 2019,San Patricio,TX,"San Patricio, TX",45892,0,961,41186,4706,1.11
 2020,San Patricio,TX,"San Patricio, TX",47470,3,1077,46157,1313,1.03
 2021,San Patricio,TX,"San Patricio, TX",51392,8,1232,52800,-1408,0.97
 2019,San Saba,TX,"San Saba, TX",44005,0,753,32271,11734,1.36
 2020,San Saba,TX,"San Saba, TX",41586,-6,1043,44700,-3114,0.93
 2021,San Saba,TX,"San Saba, TX",43735,5,2112,90514,-46779,0.48
 2019,Sanborn,SD,"Sanborn, SD",53894,0,532,22800,31094,2.36
 2020,Sanborn,SD,"Sanborn, SD",62682,16,343,14700,47982,4.26
 2021,Sanborn,SD,"Sanborn, SD",64677,3,651,27900,36777,2.32
 2019,Sangamon,IL,"Sangamon, IL",49465,0,665,28500,20965,1.74
 2020,Sangamon,IL,"Sangamon, IL",53056,7,639,27386,25670,1.94
 2021,Sangamon,IL,"Sangamon, IL",57206,8,542,23229,33977,2.46
 2019,Sanilac,MI,"Sanilac, MI",38325,0,652,27943,10382,1.37
 2020,Sanilac,MI,"Sanilac, MI",44249,16,734,31457,12792,1.41
 2021,Sanilac,MI,"Sanilac, MI",47144,7,915,39214,7930,1.2
 2019,Sanpete,UT,"Sanpete, UT",32845,0,1281,54900,-22055,0.6
 2020,Sanpete,UT,"Sanpete, UT",36656,12,1435,61500,-24844,0.6
 2021,Sanpete,UT,"Sanpete, UT",39139,7,2089,89529,-50390,0.44
 2019,Santa Barbara,CA,"Santa Barbara, CA",63586,0,4687,200871,-137285,0.32
 2020,Santa Barbara,CA,"Santa Barbara, CA",69457,9,7131,305614,-236157,0.23
 2021,Santa Barbara,CA,"Santa Barbara, CA",73995,7,6197,265586,-191591,0.28
 2019,Santa Clara,CA,"Santa Clara, CA",113693,0,5420,232286,-118593,0.49
 2020,Santa Clara,CA,"Santa Clara, CA",122785,8,5923,253843,-131058,0.48
 2021,Santa Clara,CA,"Santa Clara, CA",138724,13,6181,264900,-126176,0.52
 2019,Santa Cruz,AZ,"Santa Cruz, AZ",38555,0,1523,65271,-26716,0.59
 2020,Santa Cruz,AZ,"Santa Cruz, AZ",43734,13,1697,72729,-28995,0.6
 2021,Santa Cruz,AZ,"Santa Cruz, AZ",46828,7,1828,78343,-31515,0.6
 2019,Santa Cruz,CA,"Santa Cruz, CA",70129,0,4376,187543,-117414,0.37
 2020,Santa Cruz,CA,"Santa Cruz, CA",77181,10,4437,190157,-112976,0.41
 2021,Santa Cruz,CA,"Santa Cruz, CA",85554,11,6226,266829,-181275,0.32
 2019,Santa Fe,NM,"Santa Fe, NM",61879,0,2829,121243,-59364,0.51
 2020,Santa Fe,NM,"Santa Fe, NM",65042,5,2984,127886,-62844,0.51
 2021,Santa Fe,NM,"Santa Fe, NM",69528,7,3341,143186,-73658,0.49
 2019,Santa Rosa,FL,"Santa Rosa, FL",47484,0,1280,54857,-7373,0.87
 2020,Santa Rosa,FL,"Santa Rosa, FL",50016,5,1341,57471,-7455,0.87
 2021,Santa Rosa,FL,"Santa Rosa, FL",53778,8,1920,82286,-28508,0.65
 2019,Sarasota,FL,"Sarasota, FL",72499,0,1686,72257,242,1
 2020,Sarasota,FL,"Sarasota, FL",75070,4,1846,79114,-4044,0.95
 2021,Sarasota,FL,"Sarasota, FL",78815,5,2430,104143,-25328,0.76
 2019,Saratoga,NY,"Saratoga, NY",67477,0,1765,75643,-8166,0.89
 2020,Saratoga,NY,"Saratoga, NY",71652,6,1847,79157,-7505,0.91
 2021,Saratoga,NY,"Saratoga, NY",75651,6,2151,92186,-16535,0.82
 2019,Sargent,ND,"Sargent, ND",62204,0,492,21086,41118,2.95
 2020,Sargent,ND,"Sargent, ND",68049,9,387,16586,51463,4.1
 2021,Sargent,ND,"Sargent, ND",74799,10,1137,48729,26070,1.53
 2019,Sarpy,NE,"Sarpy, NE",52202,0,1587,68014,-15812,0.77
 2020,Sarpy,NE,"Sarpy, NE",54900,5,1614,69171,-14271,0.79
 2021,Sarpy,NE,"Sarpy, NE",58084,6,1964,84171,-26087,0.69
 2019,Sauk,WI,"Sauk, WI",52788,0,1134,48600,4188,1.09
 2020,Sauk,WI,"Sauk, WI",56206,7,1341,57471,-1265,0.98
 2021,Sauk,WI,"Sauk, WI",60631,8,1381,59186,1445,1.02
 2019,Saunders,NE,"Saunders, NE",53994,0,1167,50014,3980,1.08
 2020,Saunders,NE,"Saunders, NE",57644,7,1366,58543,-899,0.98
 2021,Saunders,NE,"Saunders, NE",61840,7,1366,58543,3297,1.06
 2019,Sawyer,WI,"Sawyer, WI",45047,0,1178,50486,-5439,0.89
 2020,Sawyer,WI,"Sawyer, WI",47325,5,1331,57043,-9718,0.83
 2021,Sawyer,WI,"Sawyer, WI",50445,7,1250,53571,-3126,0.94
 2019,Schenectady,NY,"Schenectady, NY",53917,0,960,41143,12774,1.31
 2020,Schenectady,NY,"Schenectady, NY",58435,8,1040,44571,13864,1.31
 2021,Schenectady,NY,"Schenectady, NY",62484,7,1131,48471,14013,1.29
 2019,Schleicher,TX,"Schleicher, TX",46929,0,420,18000,28929,2.61
 2020,Schleicher,TX,"Schleicher, TX",49660,6,703,30129,19531,1.65
 2021,Schleicher,TX,"Schleicher, TX",51775,4,859,36814,14961,1.41
 2019,Schley,GA,"Schley, GA",37443,0,755,32357,5086,1.16
 2020,Schley,GA,"Schley, GA",39972,7,654,28029,11943,1.43
 2021,Schley,GA,"Schley, GA",43917,10,763,32700,11217,1.34
 2019,Schoharie,NY,"Schoharie, NY",45273,0,790,33857,11416,1.34
 2020,Schoharie,NY,"Schoharie, NY",49123,9,817,35014,14109,1.4
 2021,Schoharie,NY,"Schoharie, NY",52027,6,879,37671,14356,1.38
 2019,Schoolcraft,MI,"Schoolcraft, MI",41573,0,592,25371,16202,1.64
 2020,Schoolcraft,MI,"Schoolcraft, MI",46639,12,633,27129,19510,1.72
 2021,Schoolcraft,MI,"Schoolcraft, MI",49103,5,1133,48557,546,1.01
 2019,Schuyler,IL,"Schuyler, IL",43341,0,411,17614,25727,2.46
 2020,Schuyler,IL,"Schuyler, IL",48279,11,603,25843,22436,1.87
 2021,Schuyler,IL,"Schuyler, IL",51383,6,550,23571,27812,2.18
 2019,Schuyler,MO,"Schuyler, MO",32969,0,476,20400,12569,1.62
 2020,Schuyler,MO,"Schuyler, MO",37161,13,260,11143,26018,3.33
 2021,Schuyler,MO,"Schuyler, MO",38544,4,827,35443,3101,1.09
 2019,Schuyler,NY,"Schuyler, NY",42715,0,822,35229,7486,1.21
 2020,Schuyler,NY,"Schuyler, NY",46769,10,1211,51900,-5131,0.9
 2021,Schuyler,NY,"Schuyler, NY",49811,7,1263,54129,-4318,0.92
 2019,Schuylkill,PA,"Schuylkill, PA",42971,0,386,16543,26428,2.6
 2020,Schuylkill,PA,"Schuylkill, PA",46834,9,563,24129,22705,1.94
 2021,Schuylkill,PA,"Schuylkill, PA",49451,6,494,21171,28280,2.34
 2019,Scioto,OH,"Scioto, OH",41291,0,515,22071,19220,1.87
 2020,Scioto,OH,"Scioto, OH",43698,6,541,23186,20512,1.88
 2021,Scioto,OH,"Scioto, OH",46946,7,768,32914,14032,1.43
 2019,Scott,AR,"Scott, AR",32039,0,431,18471,13568,1.73
 2020,Scott,AR,"Scott, AR",33703,5,614,26314,7389,1.28
 2021,Scott,AR,"Scott, AR",38790,15,622,26657,12133,1.46
 2019,Scott,IA,"Scott, IA",54281,0,1189,50957,3324,1.07
 2020,Scott,IA,"Scott, IA",57360,6,1167,50014,7346,1.15
 2021,Scott,IA,"Scott, IA",60349,5,914,39171,21178,1.54
 2019,Scott,IL,"Scott, IL",40420,0,396,16971,23449,2.38
 2020,Scott,IL,"Scott, IL",46038,14,263,11271,34767,4.08
 2021,Scott,IL,"Scott, IL",52741,15,283,12129,40612,4.35
 2019,Scott,IN,"Scott, IN",37960,0,652,27943,10017,1.36
 2020,Scott,IN,"Scott, IN",40916,8,801,34329,6587,1.19
 2021,Scott,IN,"Scott, IN",44678,9,882,37800,6878,1.18
 2019,Scott,KS,"Scott, KS",52615,0,350,15000,37615,3.51
 2020,Scott,KS,"Scott, KS",58451,11,943,40414,18037,1.45
 2021,Scott,KS,"Scott, KS",60794,4,1220,52286,8508,1.16
 2019,Scott,KY,"Scott, KY",46155,0,1294,55457,-9302,0.83
 2020,Scott,KY,"Scott, KY",49207,7,1457,62443,-13236,0.79
 2021,Scott,KY,"Scott, KY",52325,6,1546,66257,-13932,0.79
 2019,Scott,MN,"Scott, MN",62909,0,2023,86700,-23791,0.73
 2020,Scott,MN,"Scott, MN",65602,4,1927,82586,-16984,0.79
 2021,Scott,MN,"Scott, MN",69243,6,2049,87814,-18571,0.79
 2019,Scott,MO,"Scott, MO",41226,0,617,26443,14783,1.56
 2020,Scott,MO,"Scott, MO",44714,9,595,25500,19214,1.75
 2021,Scott,MO,"Scott, MO",47750,7,651,27900,19850,1.71
 2019,Scott,MS,"Scott, MS",31765,0,645,27643,4122,1.15
 2020,Scott,MS,"Scott, MS",32961,4,558,23914,9047,1.38
 2021,Scott,MS,"Scott, MS",37792,15,811,34757,3035,1.09
 2019,Scott,TN,"Scott, TN",31373,0,644,27600,3773,1.14
 2020,Scott,TN,"Scott, TN",34229,9,809,34671,-442,0.99
 2021,Scott,TN,"Scott, TN",37333,9,959,41100,-3767,0.91
 2019,Scott,VA,"Scott, VA",33546,0,479,20529,13017,1.63
 2020,Scott,VA,"Scott, VA",36009,7,619,26529,9480,1.36
 2021,Scott,VA,"Scott, VA",39583,10,678,29057,10526,1.36
 2019,Scotts Bluff,NE,"Scotts Bluff, NE",45546,0,824,35314,10232,1.29
 2020,Scotts Bluff,NE,"Scotts Bluff, NE",49089,8,907,38871,10218,1.26
 2021,Scotts Bluff,NE,"Scotts Bluff, NE",51337,5,861,36900,14437,1.39
 2019,Screven,GA,"Screven, GA",34667,0,545,23357,11310,1.48
 2020,Screven,GA,"Screven, GA",37736,9,521,22329,15407,1.69
 2021,Screven,GA,"Screven, GA",40137,6,723,30986,9151,1.3
 2019,Scurry,TX,"Scurry, TX",44591,0,545,23357,21234,1.91
 2020,Scurry,TX,"Scurry, TX",44706,0,611,26186,18520,1.71
 2021,Scurry,TX,"Scurry, TX",47138,5,698,29914,17224,1.58
 2019,Searcy,AR,"Searcy, AR",28574,0,534,22886,5688,1.25
 2020,Searcy,AR,"Searcy, AR",31731,11,617,26443,5288,1.2
 2021,Searcy,AR,"Searcy, AR",34335,8,768,32914,1421,1.04
 2019,Sebastian,AR,"Sebastian, AR",43368,0,775,33214,10154,1.31
 2020,Sebastian,AR,"Sebastian, AR",45505,5,803,34414,11091,1.32
 2021,Sebastian,AR,"Sebastian, AR",48556,7,951,40757,7799,1.19
 2019,Sedgwick,CO,"Sedgwick, CO",42382,0,508,21771,20611,1.95
 2020,Sedgwick,CO,"Sedgwick, CO",41472,-2,940,40286,1186,1.03
 2021,Sedgwick,CO,"Sedgwick, CO",51705,25,892,38229,13476,1.35
 2019,Sedgwick,KS,"Sedgwick, KS",53263,0,997,42729,10534,1.25
 2020,Sedgwick,KS,"Sedgwick, KS",55122,4,1100,47143,7979,1.17
 2021,Sedgwick,KS,"Sedgwick, KS",57713,5,1149,49243,8470,1.17
 2019,Seminole,FL,"Seminole, FL",50950,0,1488,63771,-12821,0.8
 2020,Seminole,FL,"Seminole, FL",52916,4,1590,68143,-15227,0.78
 2021,Seminole,FL,"Seminole, FL",58539,11,1845,79071,-20532,0.74
 2019,Seminole,GA,"Seminole, GA",40964,0,745,31929,9035,1.28
 2020,Seminole,GA,"Seminole, GA",44322,8,743,31843,12479,1.39
 2021,Seminole,GA,"Seminole, GA",46274,4,912,39086,7188,1.18
 2019,Seminole,OK,"Seminole, OK",35993,0,372,15943,20050,2.26
 2020,Seminole,OK,"Seminole, OK",38386,7,453,19414,18972,1.98
 2021,Seminole,OK,"Seminole, OK",41119,7,715,30643,10476,1.34
 2019,Seneca,NY,"Seneca, NY",40586,0,726,31114,9472,1.3
 2020,Seneca,NY,"Seneca, NY",44704,10,770,33000,11704,1.35
 2021,Seneca,NY,"Seneca, NY",47269,6,664,28457,18812,1.66
 2019,Seneca,OH,"Seneca, OH",40328,0,494,21171,19157,1.9
 2020,Seneca,OH,"Seneca, OH",44981,12,446,19114,25867,2.35
 2021,Seneca,OH,"Seneca, OH",47605,6,628,26914,20691,1.77
 2019,Sequatchie,TN,"Sequatchie, TN",38090,0,1135,48643,-10553,0.78
 2020,Sequatchie,TN,"Sequatchie, TN",41286,8,1312,56229,-14943,0.73
 2021,Sequatchie,TN,"Sequatchie, TN",43709,6,1302,55800,-12091,0.78
 2019,Sequoyah,OK,"Sequoyah, OK",35943,0,783,33557,2386,1.07
 2020,Sequoyah,OK,"Sequoyah, OK",39081,9,792,33943,5138,1.15
 2021,Sequoyah,OK,"Sequoyah, OK",42780,10,982,42086,694,1.02
 2019,Sevier,AR,"Sevier, AR",33325,0,768,32914,411,1.01
 2020,Sevier,AR,"Sevier, AR",35030,5,762,32657,2373,1.07
 2021,Sevier,AR,"Sevier, AR",41322,18,784,33600,7722,1.23
 2019,Sevier,TN,"Sevier, TN",43223,0,1344,57600,-14377,0.75
 2020,Sevier,TN,"Sevier, TN",46027,7,1765,75643,-29616,0.61
 2021,Sevier,TN,"Sevier, TN",49012,7,2929,125529,-76517,0.39
 2019,Sevier,UT,"Sevier, UT",36186,0,1020,43714,-7528,0.83
 2020,Sevier,UT,"Sevier, UT",39370,9,1056,45257,-5887,0.87
 2021,Sevier,UT,"Sevier, UT",41983,7,1810,77571,-35588,0.54
 2019,Seward,KS,"Seward, KS",37214,0,690,29571,7643,1.26
 2020,Seward,KS,"Seward, KS",41839,12,638,27343,14496,1.53
 2021,Seward,KS,"Seward, KS",44209,6,640,27429,16780,1.61
 2019,Seward,NE,"Seward, NE",51016,0,1236,52971,-1955,0.96
 2020,Seward,NE,"Seward, NE",55580,9,1112,47657,7923,1.17
 2021,Seward,NE,"Seward, NE",58829,6,1089,46671,12158,1.26
 2019,Shackelford,TX,"Shackelford, TX",96159,0,782,33514,62645,2.87
 2020,Shackelford,TX,"Shackelford, TX",88578,-8,869,37243,51335,2.38
 2021,Shackelford,TX,"Shackelford, TX",93075,5,804,34457,58618,2.7
 2019,Shannon,MO,"Shannon, MO",34946,0,839,35957,-1011,0.97
 2020,Shannon,MO,"Shannon, MO",38917,11,623,26700,12217,1.46
 2021,Shannon,MO,"Shannon, MO",41200,6,1070,45857,-4657,0.9
 2019,Sharkey,MS,"Sharkey, MS",36950,0,580,24857,12093,1.49
 2020,Sharkey,MS,"Sharkey, MS",44102,19,803,34414,9688,1.28
 2021,Sharkey,MS,"Sharkey, MS",50467,14,767,32871,17596,1.54
 2019,Sharp,AR,"Sharp, AR",34817,0,498,21343,13474,1.63
 2020,Sharp,AR,"Sharp, AR",36583,5,477,20443,16140,1.79
 2021,Sharp,AR,"Sharp, AR",41025,12,908,38914,2111,1.05
 2019,Shasta,CA,"Shasta, CA",46113,0,1577,67586,-21473,0.68
 2020,Shasta,CA,"Shasta, CA",51514,12,1669,71529,-20015,0.72
 2021,Shasta,CA,"Shasta, CA",54972,7,2110,90429,-35457,0.61
 2019,Shawano,WI,"Shawano, WI",44022,0,612,26229,17793,1.68
 2020,Shawano,WI,"Shawano, WI",47291,7,687,29443,17848,1.61
 2021,Shawano,WI,"Shawano, WI",49746,5,845,36214,13532,1.37
 2019,Shawnee,KS,"Shawnee, KS",47495,0,537,23014,24481,2.06
 2020,Shawnee,KS,"Shawnee, KS",51008,7,639,27386,23622,1.86
 2021,Shawnee,KS,"Shawnee, KS",54066,6,734,31457,22609,1.72
 2019,Sheboygan,WI,"Sheboygan, WI",52696,0,966,41400,11296,1.27
 2020,Sheboygan,WI,"Sheboygan, WI",55282,5,1090,46714,8568,1.18
 2021,Sheboygan,WI,"Sheboygan, WI",58425,6,1173,50271,8154,1.16
 2019,Shelby,AL,"Shelby, AL",57963,0,1592,68229,-10266,0.85
 2020,Shelby,AL,"Shelby, AL",60598,5,1688,72343,-11745,0.84
 2021,Shelby,AL,"Shelby, AL",64350,6,2084,89314,-24964,0.72
 2019,Shelby,IA,"Shelby, IA",51643,0,634,27171,24472,1.9
 2020,Shelby,IA,"Shelby, IA",54408,5,693,29700,24708,1.83
 2021,Shelby,IA,"Shelby, IA",61414,13,601,25757,35657,2.38
 2019,Shelby,IL,"Shelby, IL",42023,0,603,25843,16180,1.63
 2020,Shelby,IL,"Shelby, IL",46683,11,586,25114,21569,1.86
 2021,Shelby,IL,"Shelby, IL",51977,11,575,24643,27334,2.11
 2019,Shelby,IN,"Shelby, IN",44467,0,694,29743,14724,1.5
 2020,Shelby,IN,"Shelby, IN",47828,8,669,28671,19157,1.67
 2021,Shelby,IN,"Shelby, IN",52065,9,1203,51557,508,1.01
 2019,Shelby,KY,"Shelby, KY",48177,0,1632,69943,-21766,0.69
 2020,Shelby,KY,"Shelby, KY",51798,8,1526,65400,-13602,0.79
 2021,Shelby,KY,"Shelby, KY",55471,7,1671,71614,-16143,0.77
 2019,Shelby,MO,"Shelby, MO",38989,0,354,15171,23818,2.57
 2020,Shelby,MO,"Shelby, MO",43499,12,295,12643,30856,3.44
 2021,Shelby,MO,"Shelby, MO",48578,12,387,16586,31992,2.93
 2019,Shelby,OH,"Shelby, OH",45896,0,642,27514,18382,1.67
 2020,Shelby,OH,"Shelby, OH",49486,8,569,24386,25100,2.03
 2021,Shelby,OH,"Shelby, OH",52547,6,822,35229,17318,1.49
 2019,Shelby,TN,"Shelby, TN",51067,0,763,32700,18367,1.56
 2020,Shelby,TN,"Shelby, TN",54427,7,933,39986,14441,1.36
 2021,Shelby,TN,"Shelby, TN",59212,9,979,41957,17255,1.41
 2019,Shelby,TX,"Shelby, TX",43354,0,737,31586,11768,1.37
 2020,Shelby,TX,"Shelby, TX",47107,9,700,30000,17107,1.57
 2021,Shelby,TX,"Shelby, TX",54640,16,894,38314,16326,1.43
 2019,Sherburne,MN,"Sherburne, MN",49291,0,1481,63471,-14180,0.78
 2020,Sherburne,MN,"Sherburne, MN",52201,6,1521,65186,-12985,0.8
 2021,Sherburne,MN,"Sherburne, MN",55341,6,1725,73929,-18588,0.75
 2019,Sheridan,KS,"Sheridan, KS",46978,0,480,20571,26407,2.28
 2020,Sheridan,KS,"Sheridan, KS",56134,20,784,33600,22534,1.67
 2021,Sheridan,KS,"Sheridan, KS",56735,1,375,16071,40664,3.53
 2019,Sheridan,MT,"Sheridan, MT",47259,0,709,30386,16873,1.56
 2020,Sheridan,MT,"Sheridan, MT",53773,14,839,35957,17816,1.5
 2021,Sheridan,MT,"Sheridan, MT",55476,3,563,24129,31347,2.3
 2019,Sheridan,ND,"Sheridan, ND",48090,0,120,5143,42947,9.35
 2020,Sheridan,ND,"Sheridan, ND",61315,28,182,7800,53515,7.86
 2021,Sheridan,ND,"Sheridan, ND",78328,28,239,10243,68085,7.65
 2019,Sheridan,NE,"Sheridan, NE",50584,0,813,34843,15741,1.45
 2020,Sheridan,NE,"Sheridan, NE",56304,11,1101,47186,9118,1.19
 2021,Sheridan,NE,"Sheridan, NE",60271,7,313,13414,46857,4.49
 2019,Sheridan,WY,"Sheridan, WY",59932,0,1395,59786,146,1
 2020,Sheridan,WY,"Sheridan, WY",61749,3,1872,80229,-18480,0.77
 2021,Sheridan,WY,"Sheridan, WY",64449,4,2522,108086,-43637,0.6
 2019,Sherman,KS,"Sherman, KS",41364,0,582,24943,16421,1.66
 2020,Sherman,KS,"Sherman, KS",48809,18,552,23657,25152,2.06
 2021,Sherman,KS,"Sherman, KS",52785,8,910,39000,13785,1.35
 2019,Sherman,NE,"Sherman, NE",44880,0,435,18643,26237,2.41
 2020,Sherman,NE,"Sherman, NE",51164,14,464,19886,31278,2.57
 2021,Sherman,NE,"Sherman, NE",60225,18,440,18857,41368,3.19
 2019,Sherman,OR,"Sherman, OR",55593,0,933,39986,15607,1.39
 2020,Sherman,OR,"Sherman, OR",63097,14,2037,87300,-24203,0.72
 2021,Sherman,OR,"Sherman, OR",67558,7,1638,70200,-2642,0.96
 2019,Sherman,TX,"Sherman, TX",99946,0,541,23186,76760,4.31
 2020,Sherman,TX,"Sherman, TX",95726,-4,693,29700,66026,3.22
 2021,Sherman,TX,"Sherman, TX",122945,28,786,33686,89259,3.65
 2019,Shiawassee,MI,"Shiawassee, MI",40570,0,635,27214,13356,1.49
 2020,Shiawassee,MI,"Shiawassee, MI",44809,10,604,25886,18923,1.73
 2021,Shiawassee,MI,"Shiawassee, MI",47525,6,881,37757,9768,1.26
 2019,Shoshone,ID,"Shoshone, ID",36449,0,717,30729,5720,1.19
 2020,Shoshone,ID,"Shoshone, ID",41787,15,906,38829,2958,1.08
 2021,Shoshone,ID,"Shoshone, ID",45434,9,1759,75386,-29952,0.6
 2019,Sibley,MN,"Sibley, MN",47861,0,799,34243,13618,1.4
 2020,Sibley,MN,"Sibley, MN",53512,12,876,37543,15969,1.43
 2021,Sibley,MN,"Sibley, MN",58242,9,1119,47957,10285,1.21
 2019,Sierra,CA,"Sierra, CA",41365,0,1541,66043,-24678,0.63
 2020,Sierra,CA,"Sierra, CA",44542,8,2016,86400,-41858,0.52
 2021,Sierra,CA,"Sierra, CA",47135,6,2544,109029,-61894,0.43
 2019,Sierra,NM,"Sierra, NM",39373,0,722,30943,8430,1.27
 2020,Sierra,NM,"Sierra, NM",45403,15,974,41743,3660,1.09
 2021,Sierra,NM,"Sierra, NM",49778,10,1145,49071,707,1.01
 2019,Silver Bow,MT,"Silver Bow, MT",48451,0,770,33000,15451,1.47
 2020,Silver Bow,MT,"Silver Bow, MT",51180,6,919,39386,11794,1.3
 2021,Silver Bow,MT,"Silver Bow, MT",54704,7,1312,56229,-1525,0.97
 2019,Simpson,KY,"Simpson, KY",37210,0,835,35786,1424,1.04
 2020,Simpson,KY,"Simpson, KY",40876,10,894,38314,2562,1.07
 2021,Simpson,KY,"Simpson, KY",44178,8,1257,53871,-9693,0.82
 2019,Simpson,MS,"Simpson, MS",38405,0,693,29700,8705,1.29
 2020,Simpson,MS,"Simpson, MS",40004,4,735,31500,8504,1.27
 2021,Simpson,MS,"Simpson, MS",44174,10,696,29829,14345,1.48
 2019,Sioux,IA,"Sioux, IA",52420,0,1028,44057,8363,1.19
 2020,Sioux,IA,"Sioux, IA",54716,4,1035,44357,10359,1.23
 2021,Sioux,IA,"Sioux, IA",57558,5,921,39471,18087,1.46
 2019,Sioux,ND,"Sioux, ND",29160,0,959,41100,-11940,0.71
 2020,Sioux,ND,"Sioux, ND",35078,20,3789,162386,-127308,0.22
 2021,Sioux,ND,"Sioux, ND",36445,4,3789,162386,-125941,0.22
 2019,Sioux,NE,"Sioux, NE",59849,0,432,18514,41335,3.23
 2020,Sioux,NE,"Sioux, NE",65082,9,365,15643,49439,4.16
 2021,Sioux,NE,"Sioux, NE",74215,14,4736,202971,-128756,0.37
 2019,Siskiyou,CA,"Siskiyou, CA",43951,0,1283,54986,-11035,0.8
 2020,Siskiyou,CA,"Siskiyou, CA",49420,12,1284,55029,-5609,0.9
 2021,Siskiyou,CA,"Siskiyou, CA",52368,6,1897,81300,-28932,0.64
 2019,Skagit,WA,"Skagit, WA",54843,0,2244,96171,-41328,0.57
 2020,Skagit,WA,"Skagit, WA",58996,8,2167,92871,-33875,0.64
 2021,Skagit,WA,"Skagit, WA",64093,9,2875,123214,-59121,0.52
 2019,Skagway,AK,"Skagway, AK",77402,0,0,0,77402,0
 2020,Skagway,AK,"Skagway, AK",59045,-24,1794,76886,-17841,0.77
 2021,Skagway,AK,"Skagway, AK",71409,21,1487,63729,7680,1.12
 2019,Skamania,WA,"Skamania, WA",50414,0,2134,91457,-41043,0.55
 2020,Skamania,WA,"Skamania, WA",54042,7,2141,91757,-37715,0.59
 2021,Skamania,WA,"Skamania, WA",58554,8,3012,129086,-70532,0.45
 2019,Slope,ND,"Slope, ND",48921,0,118,5057,43864,9.67
 2020,Slope,ND,"Slope, ND",62170,27,120,5143,57027,12.09
 2021,Slope,ND,"Slope, ND",80270,29,621,26614,53656,3.02
 2019,Smith,KS,"Smith, KS",46726,0,438,18771,27955,2.49
 2020,Smith,KS,"Smith, KS",56231,20,460,19714,36517,2.85
 2021,Smith,KS,"Smith, KS",58450,4,520,22286,36164,2.62
 2019,Smith,MS,"Smith, MS",39661,0,819,35100,4561,1.13
 2020,Smith,MS,"Smith, MS",40309,2,687,29443,10866,1.37
 2021,Smith,MS,"Smith, MS",46337,15,741,31757,14580,1.46
 2019,Smith,TN,"Smith, TN",41898,0,1297,55586,-13688,0.75
 2020,Smith,TN,"Smith, TN",44033,5,1257,53871,-9838,0.82
 2021,Smith,TN,"Smith, TN",48602,10,1579,67671,-19069,0.72
 2019,Smith,TX,"Smith, TX",56639,0,1319,56529,110,1
 2020,Smith,TX,"Smith, TX",55832,-1,1295,55500,332,1.01
 2021,Smith,TX,"Smith, TX",60284,8,1713,73414,-13130,0.82
 2019,Smyth,VA,"Smyth, VA",37421,0,626,26829,10592,1.39
 2020,Smyth,VA,"Smyth, VA",40617,9,637,27300,13317,1.49
 2021,Smyth,VA,"Smyth, VA",44740,10,716,30686,14054,1.46
 2019,Snohomish,WA,"Snohomish, WA",58706,0,2526,108257,-49551,0.54
 2020,Snohomish,WA,"Snohomish, WA",63477,8,2648,113486,-50009,0.56
 2021,Snohomish,WA,"Snohomish, WA",68858,9,2837,121586,-52728,0.57
 2019,Snyder,PA,"Snyder, PA",43481,0,926,39686,3795,1.1
 2020,Snyder,PA,"Snyder, PA",47418,9,938,40200,7218,1.18
 2021,Snyder,PA,"Snyder, PA",50846,7,999,42814,8032,1.19
 2019,Socorro,NM,"Socorro, NM",35357,0,621,26614,8743,1.33
 2020,Socorro,NM,"Socorro, NM",38874,10,661,28329,10545,1.37
 2021,Socorro,NM,"Socorro, NM",42389,9,892,38229,4160,1.11
 2019,Solano,CA,"Solano, CA",51819,0,2216,94971,-43152,0.55
 2020,Solano,CA,"Solano, CA",58406,13,2299,98529,-40123,0.59
 2021,Solano,CA,"Solano, CA",65448,12,2857,122443,-56995,0.53
 2019,Somerset,MD,"Somerset, MD",31463,0,709,30386,1077,1.04
 2020,Somerset,MD,"Somerset, MD",33037,5,717,30729,2308,1.08
 2021,Somerset,MD,"Somerset, MD",37395,13,858,36771,624,1.02
 2019,Somerset,ME,"Somerset, ME",39371,0,663,28414,10957,1.39
 2020,Somerset,ME,"Somerset, ME",43610,11,718,30771,12839,1.42
 2021,Somerset,ME,"Somerset, ME",46860,8,911,39043,7817,1.2
 2019,Somerset,NJ,"Somerset, NJ",107923,0,2410,103286,4637,1.04
 2020,Somerset,NJ,"Somerset, NJ",106558,-1,2407,103157,3401,1.03
 2021,Somerset,NJ,"Somerset, NJ",113975,7,2446,104829,9146,1.09
 2019,Somerset,PA,"Somerset, PA",42173,0,844,36171,6002,1.17
 2020,Somerset,PA,"Somerset, PA",45843,9,820,35143,10700,1.3
 2021,Somerset,PA,"Somerset, PA",48135,5,794,34029,14106,1.41
 2019,Somervell,TX,"Somervell, TX",48387,0,1477,63300,-14913,0.76
 2020,Somervell,TX,"Somervell, TX",50951,5,1411,60471,-9520,0.84
 2021,Somervell,TX,"Somervell, TX",54826,8,2242,96086,-41260,0.57
 2019,Sonoma,CA,"Sonoma, CA",66715,0,3343,143271,-76556,0.47
 2020,Sonoma,CA,"Sonoma, CA",73526,10,3771,161614,-88088,0.45
 2021,Sonoma,CA,"Sonoma, CA",81006,10,3914,167743,-86737,0.48
 2019,Southeast Fairbanks,AK,"Southeast Fairbanks, AK",51956,0,1097,47014,4942,1.11
 2020,Southeast Fairbanks,AK,"Southeast Fairbanks, AK",54513,5,1010,43286,11227,1.26
 2021,Southeast Fairbanks,AK,"Southeast Fairbanks, AK",58988,8,1926,82543,-23555,0.71
 2019,Spalding,GA,"Spalding, GA",35829,0,740,31714,4115,1.13
 2020,Spalding,GA,"Spalding, GA",39157,9,1003,42986,-3829,0.91
 2021,Spalding,GA,"Spalding, GA",43098,10,1246,53400,-10302,0.81
 2019,Spartanburg,SC,"Spartanburg, SC",45010,0,1040,44571,439,1.01
 2020,Spartanburg,SC,"Spartanburg, SC",47641,6,1091,46757,884,1.02
 2021,Spartanburg,SC,"Spartanburg, SC",50596,6,1325,56786,-6190,0.89
 2019,Spencer,IN,"Spencer, IN",46564,0,855,36643,9921,1.27
 2020,Spencer,IN,"Spencer, IN",48915,5,845,36214,12701,1.35
 2021,Spencer,IN,"Spencer, IN",52615,8,1069,45814,6801,1.15
 2019,Spencer,KY,"Spencer, KY",47187,0,1458,62486,-15299,0.76
 2020,Spencer,KY,"Spencer, KY",50240,7,1544,66171,-15931,0.76
 2021,Spencer,KY,"Spencer, KY",53915,7,1803,77271,-23356,0.7
 2019,Spink,SD,"Spink, SD",55538,0,340,14571,40967,3.81
 2020,Spink,SD,"Spink, SD",71992,30,558,23914,48078,3.01
 2021,Spink,SD,"Spink, SD",76434,6,381,16329,60105,4.68
 2019,Spokane,WA,"Spokane, WA",46117,0,1643,70414,-24297,0.65
 2020,Spokane,WA,"Spokane, WA",49634,8,1778,76200,-26566,0.65
 2021,Spokane,WA,"Spokane, WA",53770,8,2161,92614,-38844,0.58
 2019,St. Bernard,LA,"St. Bernard, LA",36192,0,889,38100,-1908,0.95
 2020,St. Bernard,LA,"St. Bernard, LA",39448,9,914,39171,277,1.01
 2021,St. Bernard,LA,"St. Bernard, LA",42310,7,1438,61629,-19319,0.69
 2019,St. Charles,LA,"St. Charles, LA",50312,0,1232,52800,-2488,0.95
 2020,St. Charles,LA,"St. Charles, LA",53773,7,1217,52157,1616,1.03
 2021,St. Charles,LA,"St. Charles, LA",56921,6,1223,52414,4507,1.09
 2019,St. Charles,MO,"St. Charles, MO",55706,0,1474,63171,-7465,0.88
 2020,St. Charles,MO,"St. Charles, MO",58134,4,1555,66643,-8509,0.87
 2021,St. Charles,MO,"St. Charles, MO",61752,6,1646,70543,-8791,0.88
 2019,St. Clair,AL,"St. Clair, AL",41418,0,1111,47614,-6196,0.87
 2020,St. Clair,AL,"St. Clair, AL",43673,5,1198,51343,-7670,0.85
 2021,St. Clair,AL,"St. Clair, AL",47117,8,1400,60000,-12883,0.79
 2019,St. Clair,IL,"St. Clair, IL",46492,0,766,32829,13663,1.42
 2020,St. Clair,IL,"St. Clair, IL",50387,8,668,28629,21758,1.76
 2021,St. Clair,IL,"St. Clair, IL",54185,8,729,31243,22942,1.73
 2019,St. Clair,MI,"St. Clair, MI",45733,0,977,41871,3862,1.09
 2020,St. Clair,MI,"St. Clair, MI",50390,10,1043,44700,5690,1.13
 2021,St. Clair,MI,"St. Clair, MI",52805,5,1168,50057,2748,1.05
 2019,St. Clair,MO,"St. Clair, MO",31316,0,534,22886,8430,1.37
 2020,St. Clair,MO,"St. Clair, MO",34466,10,609,26100,8366,1.32
 2021,St. Clair,MO,"St. Clair, MO",36671,6,803,34414,2257,1.07
 2019,St. Croix,WI,"St. Croix, WI",57706,0,1542,66086,-8380,0.87
 2020,St. Croix,WI,"St. Croix, WI",59997,4,1682,72086,-12089,0.83
 2021,St. Croix,WI,"St. Croix, WI",63800,6,1805,77357,-13557,0.82
 2019,St. Francis,AR,"St. Francis, AR",30215,0,505,21643,8572,1.4
 2020,St. Francis,AR,"St. Francis, AR",33394,11,449,19243,14151,1.74
 2021,St. Francis,AR,"St. Francis, AR",36761,10,555,23786,12975,1.55
 2019,St. Francois,MO,"St. Francois, MO",35222,0,694,29743,5479,1.18
 2020,St. Francois,MO,"St. Francois, MO",37971,8,704,30171,7800,1.26
 2021,St. Francois,MO,"St. Francois, MO",40227,6,904,38743,1484,1.04
 2019,St. Helena,LA,"St. Helena, LA",42128,0,990,42429,-301,0.99
 2020,St. Helena,LA,"St. Helena, LA",46176,10,1009,43243,2933,1.07
 2021,St. Helena,LA,"St. Helena, LA",50554,10,1347,57729,-7175,0.88
 2019,St. James,LA,"St. James, LA",54886,0,813,34843,20043,1.58
 2020,St. James,LA,"St. James, LA",57847,5,709,30386,27461,1.9
 2021,St. James,LA,"St. James, LA",61471,6,725,31071,30400,1.98
 2019,St. John The Baptist,LA,"St. John The Baptist, LA",41980,0,766,32829,9151,1.28
 2020,St. John The Baptist,LA,"St. John The Baptist, LA",45407,8,805,34500,10907,1.32
 2021,St. John The Baptist,LA,"St. John The Baptist, LA",49045,8,773,33129,15916,1.48
 2019,St. Johns,FL,"St. Johns, FL",74335,0,1817,77871,-3536,0.95
 2020,St. Johns,FL,"St. Johns, FL",76387,3,1880,80571,-4184,0.95
 2021,St. Johns,FL,"St. Johns, FL",80062,5,2433,104271,-24209,0.77
 2019,St. Joseph,IN,"St. Joseph, IN",47847,0,717,30729,17118,1.56
 2020,St. Joseph,IN,"St. Joseph, IN",50612,6,932,39943,10669,1.27
 2021,St. Joseph,IN,"St. Joseph, IN",56122,11,973,41700,14422,1.35
 2019,St. Joseph,MI,"St. Joseph, MI",38688,0,859,36814,1874,1.05
 2020,St. Joseph,MI,"St. Joseph, MI",43372,12,868,37200,6172,1.17
 2021,St. Joseph,MI,"St. Joseph, MI",46199,7,948,40629,5570,1.14
 2019,St. Lawrence,NY,"St. Lawrence, NY",39181,0,558,23914,15267,1.64
 2020,St. Lawrence,NY,"St. Lawrence, NY",42821,9,582,24943,17878,1.72
 2021,St. Lawrence,NY,"St. Lawrence, NY",45626,7,594,25457,20169,1.79
 2019,St. Louis,MN,"St. Louis, MN",48188,0,820,35143,13045,1.37
 2020,St. Louis,MN,"St. Louis, MN",51537,7,947,40586,10951,1.27
 2021,St. Louis,MN,"St. Louis, MN",55303,7,1052,45086,10217,1.23
 2019,St. Louis,MO,"St. Louis, MO",73575,0,1292,55371,18204,1.33
 2020,St. Louis,MO,"St. Louis, MO",77419,5,1285,55071,22348,1.41
 2021,St. Louis,MO,"St. Louis, MO",81829,6,1241,53186,28643,1.54
 2019,St. Lucie,FL,"St. Lucie, FL",43308,0,1248,53486,-10178,0.81
 2020,St. Lucie,FL,"St. Lucie, FL",45760,6,1275,54643,-8883,0.84
 2021,St. Lucie,FL,"St. Lucie, FL",50038,9,1897,81300,-31262,0.62
 2019,St. Martin,LA,"St. Martin, LA",39827,0,1043,44700,-4873,0.89
 2020,St. Martin,LA,"St. Martin, LA",43012,8,1104,47314,-4302,0.91
 2021,St. Martin,LA,"St. Martin, LA",46248,8,1139,48814,-2566,0.95
 2019,St. Mary,LA,"St. Mary, LA",41049,0,738,31629,9420,1.3
 2020,St. Mary,LA,"St. Mary, LA",45507,11,647,27729,17778,1.64
 2021,St. Mary,LA,"St. Mary, LA",49034,8,950,40714,8320,1.2
 2019,St. Mary's,MD,"St. Mary's, MD",58853,0,1440,61714,-2861,0.95
 2020,St. Mary's,MD,"St. Mary's, MD",61874,5,1662,71229,-9355,0.87
 2021,St. Mary's,MD,"St. Mary's, MD",65762,6,1831,78471,-12709,0.84
 2019,St. Tammany,LA,"St. Tammany, LA",69471,0,1304,55886,13585,1.24
 2020,St. Tammany,LA,"St. Tammany, LA",66999,-4,1321,56614,10385,1.18
 2021,St. Tammany,LA,"St. Tammany, LA",71361,7,1692,72514,-1153,0.98
 2019,Stafford,KS,"Stafford, KS",46008,0,226,9686,36322,4.75
 2020,Stafford,KS,"Stafford, KS",49991,9,268,11486,38505,4.35
 2021,Stafford,KS,"Stafford, KS",52643,5,237,10157,42486,5.18
 2019,Stafford,VA,"Stafford, VA",56078,0,1977,84729,-28651,0.66
 2020,Stafford,VA,"Stafford, VA",58744,5,2077,89014,-30270,0.66
 2021,Stafford,VA,"Stafford, VA",62954,7,2159,92529,-29575,0.68
 2019,Stanislaus,CA,"Stanislaus, CA",43729,0,1664,71314,-27585,0.61
 2020,Stanislaus,CA,"Stanislaus, CA",49128,12,1817,77871,-28743,0.63
 2021,Stanislaus,CA,"Stanislaus, CA",52356,7,2296,98400,-46044,0.53
 2019,Stanley,SD,"Stanley, SD",66010,0,1475,63214,2796,1.04
 2020,Stanley,SD,"Stanley, SD",66966,1,1549,66386,580,1.01
 2021,Stanley,SD,"Stanley, SD",78300,17,1719,73671,4629,1.06
 2019,Stanly,NC,"Stanly, NC",40374,0,1213,51986,-11612,0.78
 2020,Stanly,NC,"Stanly, NC",43279,7,1216,52114,-8835,0.83
 2021,Stanly,NC,"Stanly, NC",46827,8,1400,60000,-13173,0.78
 2019,Stanton,KS,"Stanton, KS",69728,0,413,17700,52028,3.94
 2020,Stanton,KS,"Stanton, KS",85360,22,969,41529,43831,2.06
 2021,Stanton,KS,"Stanton, KS",94353,11,448,19200,75153,4.91
 2019,Stanton,NE,"Stanton, NE",47073,0,733,31414,15659,1.5
 2020,Stanton,NE,"Stanton, NE",54803,16,856,36686,18117,1.49
 2021,Stanton,NE,"Stanton, NE",61286,12,1088,46629,14657,1.31
 2019,Stark,IL,"Stark, IL",41033,0,350,15000,26033,2.74
 2020,Stark,IL,"Stark, IL",48612,19,374,16029,32583,3.03
 2021,Stark,IL,"Stark, IL",56551,16,369,15814,40737,3.58
 2019,Stark,ND,"Stark, ND",63393,0,1182,50657,12736,1.25
 2020,Stark,ND,"Stark, ND",61563,-3,1153,49414,12149,1.25
 2021,Stark,ND,"Stark, ND",62553,2,1117,47871,14682,1.31
 2019,Stark,OH,"Stark, OH",45901,0,694,29743,16158,1.54
 2020,Stark,OH,"Stark, OH",49197,7,783,33557,15640,1.47
 2021,Stark,OH,"Stark, OH",52426,7,831,35614,16812,1.47
 2019,Starke,IN,"Starke, IN",34983,0,674,28886,6097,1.21
 2020,Starke,IN,"Starke, IN",38297,10,663,28414,9883,1.35
 2021,Starke,IN,"Starke, IN",42083,10,985,42214,-131,1
 2019,Starr,TX,"Starr, TX",27516,0,674,28886,-1370,0.95
 2020,Starr,TX,"Starr, TX",31511,15,552,23657,7854,1.33
 2021,Starr,TX,"Starr, TX",34933,11,817,35014,-81,1
 2019,Ste. Genevieve,MO,"Ste. Genevieve, MO",41160,0,637,27300,13860,1.51
 2020,Ste. Genevieve,MO,"Ste. Genevieve, MO",44215,7,772,33086,11129,1.34
 2021,Ste. Genevieve,MO,"Ste. Genevieve, MO",46578,5,1041,44614,1964,1.04
 2019,Stearns,MN,"Stearns, MN",48925,0,1148,49200,-275,0.99
 2020,Stearns,MN,"Stearns, MN",53151,9,1207,51729,1422,1.03
 2021,Stearns,MN,"Stearns, MN",56711,7,1380,59143,-2432,0.96
 2019,Steele,MN,"Steele, MN",46534,0,984,42171,4363,1.1
 2020,Steele,MN,"Steele, MN",50483,9,1052,45086,5397,1.12
 2021,Steele,MN,"Steele, MN",55176,9,1122,48086,7090,1.15
 2019,Steele,ND,"Steele, ND",64659,0,876,37543,27116,1.72
 2020,Steele,ND,"Steele, ND",87451,35,599,25671,61780,3.41
 2021,Steele,ND,"Steele, ND",86280,-1,576,24686,61594,3.5
 2019,Stephens,GA,"Stephens, GA",36315,0,1006,43114,-6799,0.84
 2020,Stephens,GA,"Stephens, GA",38905,7,1175,50357,-11452,0.77
 2021,Stephens,GA,"Stephens, GA",41822,8,1256,53829,-12007,0.78
 2019,Stephens,OK,"Stephens, OK",43968,0,468,20057,23911,2.19
 2020,Stephens,OK,"Stephens, OK",45647,4,553,23700,21947,1.93
 2021,Stephens,OK,"Stephens, OK",48328,6,556,23829,24499,2.03
 2019,Stephens,TX,"Stephens, TX",45589,0,838,35914,9675,1.27
 2020,Stephens,TX,"Stephens, TX",45360,-1,662,28371,16989,1.6
 2021,Stephens,TX,"Stephens, TX",48498,7,632,27086,21412,1.79
 2019,Stephenson,IL,"Stephenson, IL",43040,0,448,19200,23840,2.24
 2020,Stephenson,IL,"Stephenson, IL",46579,8,439,18814,27765,2.48
 2021,Stephenson,IL,"Stephenson, IL",50815,9,639,27386,23429,1.86
 2019,Sterling,TX,"Sterling, TX",60248,0,911,39043,21205,1.54
 2020,Sterling,TX,"Sterling, TX",59869,-1,620,26571,33298,2.25
 2021,Sterling,TX,"Sterling, TX",65866,10,914,39171,26695,1.68
 2019,Steuben,IN,"Steuben, IN",45775,0,1143,48986,-3211,0.93
 2020,Steuben,IN,"Steuben, IN",48787,7,1287,55157,-6370,0.88
 2021,Steuben,IN,"Steuben, IN",52244,7,1565,67071,-14827,0.78
 2019,Steuben,NY,"Steuben, NY",47475,0,638,27343,20132,1.74
 2020,Steuben,NY,"Steuben, NY",51050,8,655,28071,22979,1.82
 2021,Steuben,NY,"Steuben, NY",54238,6,823,35271,18967,1.54
 2019,Stevens,KS,"Stevens, KS",44013,0,533,22843,21170,1.93
 2020,Stevens,KS,"Stevens, KS",50989,16,665,28500,22489,1.79
 2021,Stevens,KS,"Stevens, KS",52345,3,747,32014,20331,1.64
 2019,Stevens,MN,"Stevens, MN",47917,0,651,27900,20017,1.72
 2020,Stevens,MN,"Stevens, MN",56612,18,757,32443,24169,1.74
 2021,Stevens,MN,"Stevens, MN",58335,3,667,28586,29749,2.04
 2019,Stevens,WA,"Stevens, WA",40255,0,1327,56871,-16616,0.71
 2020,Stevens,WA,"Stevens, WA",43570,8,1334,57171,-13601,0.76
 2021,Stevens,WA,"Stevens, WA",47613,9,2370,101571,-53958,0.47
 2019,Stewart,GA,"Stewart, GA",27980,0,317,13586,14394,2.06
 2020,Stewart,GA,"Stewart, GA",31652,13,500,21429,10223,1.48
 2021,Stewart,GA,"Stewart, GA",32844,4,3190,136714,-103870,0.24
 2019,Stewart,TN,"Stewart, TN",42737,0,726,31114,11623,1.37
 2020,Stewart,TN,"Stewart, TN",45248,6,990,42429,2819,1.07
 2021,Stewart,TN,"Stewart, TN",48205,7,1371,58757,-10552,0.82
 2019,Stillwater,MT,"Stillwater, MT",59139,0,1733,74271,-15132,0.8
 2020,Stillwater,MT,"Stillwater, MT",62194,5,1971,84471,-22277,0.74
 2021,Stillwater,MT,"Stillwater, MT",64917,4,3294,141171,-76254,0.46
 2019,Stoddard,MO,"Stoddard, MO",37698,0,484,20743,16955,1.82
 2020,Stoddard,MO,"Stoddard, MO",40868,8,554,23743,17125,1.72
 2021,Stoddard,MO,"Stoddard, MO",45554,12,622,26657,18897,1.71
 2019,Stokes,NC,"Stokes, NC",39689,0,1165,49929,-10240,0.79
 2020,Stokes,NC,"Stokes, NC",42290,7,1174,50314,-8024,0.84
 2021,Stokes,NC,"Stokes, NC",46159,9,1240,53143,-6984,0.87
 2019,Stone,AR,"Stone, AR",31554,0,918,39343,-7789,0.8
 2020,Stone,AR,"Stone, AR",33395,6,865,37071,-3676,0.9
 2021,Stone,AR,"Stone, AR",37002,11,922,39514,-2512,0.94
 2019,Stone,MO,"Stone, MO",41537,0,1217,52157,-10620,0.8
 2020,Stone,MO,"Stone, MO",44432,7,1282,54943,-10511,0.81
 2021,Stone,MO,"Stone, MO",46852,5,1845,79071,-32219,0.59
 2019,Stone,MS,"Stone, MS",34653,0,720,30857,3796,1.12
 2020,Stone,MS,"Stone, MS",37262,8,733,31414,5848,1.19
 2021,Stone,MS,"Stone, MS",39547,6,935,40071,-524,0.99
 2019,Stonewall,TX,"Stonewall, TX",61771,0,690,29571,32200,2.09
 2020,Stonewall,TX,"Stonewall, TX",66772,8,120,5143,61629,12.98
 2021,Stonewall,TX,"Stonewall, TX",73182,10,1739,74529,-1347,0.98
 2019,Storey,NV,"Storey, NV",60420,0,1937,83014,-22594,0.73
 2020,Storey,NV,"Storey, NV",69486,15,1991,85329,-15843,0.81
 2021,Storey,NV,"Storey, NV",77775,12,2700,115714,-37939,0.67
 2019,Story,IA,"Story, IA",43682,0,1208,51771,-8089,0.84
 2020,Story,IA,"Story, IA",45618,4,1214,52029,-6411,0.88
 2021,Story,IA,"Story, IA",47923,5,1269,54386,-6463,0.88
 2019,Strafford,NH,"Strafford, NH",53852,0,1474,63171,-9319,0.85
 2020,Strafford,NH,"Strafford, NH",57449,7,1643,70414,-12965,0.82
 2021,Strafford,NH,"Strafford, NH",61139,6,1954,83743,-22604,0.73
 2019,Stutsman,ND,"Stutsman, ND",52206,0,885,37929,14277,1.38
 2020,Stutsman,ND,"Stutsman, ND",59353,14,818,35057,24296,1.69
 2021,Stutsman,ND,"Stutsman, ND",61388,3,833,35700,25688,1.72
 2019,Sublette,WY,"Sublette, WY",61618,0,1259,53957,7661,1.14
 2020,Sublette,WY,"Sublette, WY",62780,2,1225,52500,10280,1.2
 2021,Sublette,WY,"Sublette, WY",65620,5,2133,91414,-25794,0.72
 2019,Suffolk,MA,"Suffolk, MA",83428,0,3683,157843,-74415,0.53
 2020,Suffolk,MA,"Suffolk, MA",90941,9,4029,172671,-81730,0.53
 2021,Suffolk,MA,"Suffolk, MA",98644,9,3849,164957,-66313,0.6
 2019,Suffolk,NY,"Suffolk, NY",72292,0,2866,122829,-50537,0.59
 2020,Suffolk,NY,"Suffolk, NY",76687,6,2978,127629,-50942,0.6
 2021,Suffolk,NY,"Suffolk, NY",81309,6,3258,139629,-58320,0.58
 2019,Sullivan,IN,"Sullivan, IN",36116,0,315,13500,22616,2.68
 2020,Sullivan,IN,"Sullivan, IN",39300,9,364,15600,23700,2.52
 2021,Sullivan,IN,"Sullivan, IN",43091,10,469,20100,22991,2.14
 2019,Sullivan,MO,"Sullivan, MO",38969,0,459,19671,19298,1.98
 2020,Sullivan,MO,"Sullivan, MO",44289,14,446,19114,25175,2.32
 2021,Sullivan,MO,"Sullivan, MO",44139,0,373,15986,28153,2.76
 2019,Sullivan,NH,"Sullivan, NH",55373,0,1152,49371,6002,1.12
 2020,Sullivan,NH,"Sullivan, NH",59379,7,1216,52114,7265,1.14
 2021,Sullivan,NH,"Sullivan, NH",63225,7,1603,68700,-5475,0.92
 2019,Sullivan,NY,"Sullivan, NY",47370,0,905,38786,8584,1.22
 2020,Sullivan,NY,"Sullivan, NY",51175,8,955,40929,10246,1.25
 2021,Sullivan,NY,"Sullivan, NY",53874,5,1394,59743,-5869,0.9
 2019,Sullivan,PA,"Sullivan, PA",49647,0,737,31586,18061,1.57
 2020,Sullivan,PA,"Sullivan, PA",52767,6,717,30729,22038,1.72
 2021,Sullivan,PA,"Sullivan, PA",55564,5,748,32057,23507,1.73
 2019,Sullivan,TN,"Sullivan, TN",44125,0,805,34500,9625,1.28
 2020,Sullivan,TN,"Sullivan, TN",47021,7,1019,43671,3350,1.08
 2021,Sullivan,TN,"Sullivan, TN",50418,7,1190,51000,-582,0.99
 2019,Sully,SD,"Sully, SD",75293,0,964,41314,33979,1.82
 2020,Sully,SD,"Sully, SD",100044,33,958,41057,58987,2.44
 2021,Sully,SD,"Sully, SD",106241,6,1234,52886,53355,2.01
 2019,Summers,WV,"Summers, WV",36895,0,694,29743,7152,1.24
 2020,Summers,WV,"Summers, WV",39250,6,728,31200,8050,1.26
 2021,Summers,WV,"Summers, WV",42796,9,817,35014,7782,1.22
 2019,Summit,CO,"Summit, CO",76517,0,3964,169886,-93369,0.45
 2020,Summit,CO,"Summit, CO",81157,6,3212,137657,-56500,0.59
 2021,Summit,CO,"Summit, CO",86390,6,4649,199243,-112853,0.43
 2019,Summit,OH,"Summit, OH",53540,0,659,28243,25297,1.9
 2020,Summit,OH,"Summit, OH",57035,7,638,27343,29692,2.09
 2021,Summit,OH,"Summit, OH",60771,7,762,32657,28114,1.86
 2019,Summit,UT,"Summit, UT",164980,0,6220,266571,-101591,0.62
 2020,Summit,UT,"Summit, UT",174010,6,7410,317571,-143561,0.55
 2021,Summit,UT,"Summit, UT",183972,6,10695,458357,-274385,0.4
 2019,Sumner,KS,"Sumner, KS",41457,0,373,15986,25471,2.59
 2020,Sumner,KS,"Sumner, KS",45362,9,419,17957,27405,2.53
 2021,Sumner,KS,"Sumner, KS",48658,7,516,22114,26544,2.2
 2019,Sumner,TN,"Sumner, TN",52015,0,1665,71357,-19342,0.73
 2020,Sumner,TN,"Sumner, TN",54570,5,1661,71186,-16616,0.77
 2021,Sumner,TN,"Sumner, TN",59105,8,2114,90600,-31495,0.65
 2019,Sumter,AL,"Sumter, AL",32079,0,550,23571,8508,1.36
 2020,Sumter,AL,"Sumter, AL",35200,10,582,24943,10257,1.41
 2021,Sumter,AL,"Sumter, AL",38253,9,504,21600,16653,1.77
 2019,Sumter,FL,"Sumter, FL",59209,0,1261,54043,5166,1.1
 2020,Sumter,FL,"Sumter, FL",60900,3,1427,61157,-257,1
 2021,Sumter,FL,"Sumter, FL",64282,6,1772,75943,-11661,0.85
 2019,Sumter,GA,"Sumter, GA",36889,0,704,30171,6718,1.22
 2020,Sumter,GA,"Sumter, GA",39790,8,767,32871,6919,1.21
 2021,Sumter,GA,"Sumter, GA",43130,8,727,31157,11973,1.38
 2019,Sumter,SC,"Sumter, SC",40042,0,766,32829,7213,1.22
 2020,Sumter,SC,"Sumter, SC",42961,7,874,37457,5504,1.15
 2021,Sumter,SC,"Sumter, SC",47046,10,996,42686,4360,1.1
 2019,Sunflower,MS,"Sunflower, MS",29664,0,376,16114,13550,1.84
 2020,Sunflower,MS,"Sunflower, MS",33938,14,419,17957,15981,1.89
 2021,Sunflower,MS,"Sunflower, MS",37950,12,595,25500,12450,1.49
 2019,Surry,NC,"Surry, NC",39935,0,999,42814,-2879,0.93
 2020,Surry,NC,"Surry, NC",42733,7,955,40929,1804,1.04
 2021,Surry,NC,"Surry, NC",46963,10,1135,48643,-1680,0.97
 2019,Surry,VA,"Surry, VA",43176,0,868,37200,5976,1.16
 2020,Surry,VA,"Surry, VA",46775,8,951,40757,6018,1.15
 2021,Surry,VA,"Surry, VA",51892,11,1385,59357,-7465,0.87
 2019,Susquehanna,PA,"Susquehanna, PA",48990,0,860,36857,12133,1.33
 2020,Susquehanna,PA,"Susquehanna, PA",51186,5,887,38014,13172,1.35
 2021,Susquehanna,PA,"Susquehanna, PA",55354,8,1234,52886,2468,1.05
 2019,Sussex,DE,"Sussex, DE",55124,0,1652,70800,-15676,0.78
 2020,Sussex,DE,"Sussex, DE",56669,3,1721,73757,-17088,0.77
 2021,Sussex,DE,"Sussex, DE",59472,5,2394,102600,-43128,0.58
 2019,Sussex,NJ,"Sussex, NJ",63283,0,1224,52457,10826,1.21
 2020,Sussex,NJ,"Sussex, NJ",66431,5,1345,57643,8788,1.15
 2021,Sussex,NJ,"Sussex, NJ",71059,7,1499,64243,6816,1.11
 2019,Sussex,VA,"Sussex, VA",32146,0,581,24900,7246,1.29
 2020,Sussex,VA,"Sussex, VA",35242,10,710,30429,4813,1.16
 2021,Sussex,VA,"Sussex, VA",39243,11,730,31286,7957,1.25
 2019,Sutter,CA,"Sutter, CA",44212,0,1522,65229,-21017,0.68
 2020,Sutter,CA,"Sutter, CA",49710,12,1655,70929,-21219,0.7
 2021,Sutter,CA,"Sutter, CA",53017,7,2094,89743,-36726,0.59
 2019,Sutton,TX,"Sutton, TX",71242,0,798,34200,37042,2.08
 2020,Sutton,TX,"Sutton, TX",64619,-9,763,32700,31919,1.98
 2021,Sutton,TX,"Sutton, TX",68431,6,882,37800,30631,1.81
 2019,Suwannee,FL,"Suwannee, FL",34336,0,1006,43114,-8778,0.8
 2020,Suwannee,FL,"Suwannee, FL",36672,7,981,42043,-5371,0.87
 2021,Suwannee,FL,"Suwannee, FL",39039,7,1233,52843,-13804,0.74
 2019,Swain,NC,"Swain, NC",41006,0,1500,64286,-23280,0.64
 2020,Swain,NC,"Swain, NC",44824,9,1440,61714,-16890,0.73
 2021,Swain,NC,"Swain, NC",49421,10,1719,73671,-24250,0.67
 2019,Sweet Grass,MT,"Sweet Grass, MT",51626,0,1754,75171,-23545,0.69
 2020,Sweet Grass,MT,"Sweet Grass, MT",55732,8,1899,81386,-25654,0.68
 2021,Sweet Grass,MT,"Sweet Grass, MT",57852,4,4003,171557,-113705,0.34
 2019,Sweetwater,WY,"Sweetwater, WY",56619,0,1055,45214,11405,1.25
 2020,Sweetwater,WY,"Sweetwater, WY",55188,-3,1114,47743,7445,1.16
 2021,Sweetwater,WY,"Sweetwater, WY",56934,3,1082,46371,10563,1.23
 2019,Swift,MN,"Swift, MN",46446,0,475,20357,26089,2.28
 2020,Swift,MN,"Swift, MN",53559,15,447,19157,34402,2.8
 2021,Swift,MN,"Swift, MN",58433,9,359,15386,43047,3.8
 2019,Swisher,TX,"Swisher, TX",56920,0,376,16114,40806,3.53
 2020,Swisher,TX,"Swisher, TX",59169,4,480,20571,38598,2.88
 2021,Swisher,TX,"Swisher, TX",72623,23,482,20657,51966,3.52
 2019,Talbot,GA,"Talbot, GA",37464,0,848,36343,1121,1.03
 2020,Talbot,GA,"Talbot, GA",42057,12,599,25671,16386,1.64
 2021,Talbot,GA,"Talbot, GA",45385,8,1051,45043,342,1.01
 2019,Talbot,MD,"Talbot, MD",75466,0,2824,121029,-45563,0.62
 2020,Talbot,MD,"Talbot, MD",80052,6,2485,106500,-26448,0.75
 2021,Talbot,MD,"Talbot, MD",84695,6,2440,104571,-19876,0.81
 2019,Taliaferro,GA,"Taliaferro, GA",36707,0,671,28757,7950,1.28
 2020,Taliaferro,GA,"Taliaferro, GA",36369,-1,754,32314,4055,1.13
 2021,Taliaferro,GA,"Taliaferro, GA",41494,14,1719,73671,-32177,0.56
 2019,Talladega,AL,"Talladega, AL",35072,0,748,32057,3015,1.09
 2020,Talladega,AL,"Talladega, AL",37554,7,814,34886,2668,1.08
 2021,Talladega,AL,"Talladega, AL",40668,8,831,35614,5054,1.14
 2019,Tallahatchie,MS,"Tallahatchie, MS",31982,0,407,17443,14539,1.83
 2020,Tallahatchie,MS,"Tallahatchie, MS",36529,14,475,20357,16172,1.79
 2021,Tallahatchie,MS,"Tallahatchie, MS",41558,14,337,14443,27115,2.88
 2019,Tallapoosa,AL,"Tallapoosa, AL",42151,0,1457,62443,-20292,0.68
 2020,Tallapoosa,AL,"Tallapoosa, AL",44772,6,1415,60643,-15871,0.74
 2021,Tallapoosa,AL,"Tallapoosa, AL",48344,8,1353,57986,-9642,0.83
 2019,Tama,IA,"Tama, IA",45708,0,511,21900,23808,2.09
 2020,Tama,IA,"Tama, IA",51211,12,526,22543,28668,2.27
 2021,Tama,IA,"Tama, IA",58311,14,469,20100,38211,2.9
 2019,Taney,MO,"Taney, MO",37777,0,919,39386,-1609,0.96
 2020,Taney,MO,"Taney, MO",40130,6,927,39729,401,1.01
 2021,Taney,MO,"Taney, MO",42600,6,1351,57900,-15300,0.74
 2019,Tangipahoa,LA,"Tangipahoa, LA",40912,0,888,38057,2855,1.08
 2020,Tangipahoa,LA,"Tangipahoa, LA",44234,8,927,39729,4505,1.11
 2021,Tangipahoa,LA,"Tangipahoa, LA",47076,6,1218,52200,-5124,0.9
 2019,Taos,NM,"Taos, NM",37469,0,1886,80829,-43360,0.46
 2020,Taos,NM,"Taos, NM",41670,11,1946,83400,-41730,0.5
 2021,Taos,NM,"Taos, NM",44709,7,2343,100414,-55705,0.45
 2019,Tarrant,TX,"Tarrant, TX",52823,0,1413,60557,-7734,0.87
 2020,Tarrant,TX,"Tarrant, TX",54554,3,1384,59314,-4760,0.92
 2021,Tarrant,TX,"Tarrant, TX",58940,8,1582,67800,-8860,0.87
 2019,Tate,MS,"Tate, MS",38141,0,973,41700,-3559,0.91
 2020,Tate,MS,"Tate, MS",41180,8,980,42000,-820,0.98
 2021,Tate,MS,"Tate, MS",44749,9,1230,52714,-7965,0.85
 2019,Tattnall,GA,"Tattnall, GA",31135,0,552,23657,7478,1.32
 2020,Tattnall,GA,"Tattnall, GA",32553,5,502,21514,11039,1.51
 2021,Tattnall,GA,"Tattnall, GA",35616,9,798,34200,1416,1.04
 2019,Taylor,FL,"Taylor, FL",30671,0,785,33643,-2972,0.91
 2020,Taylor,FL,"Taylor, FL",33070,8,890,38143,-5073,0.87
 2021,Taylor,FL,"Taylor, FL",35156,6,954,40886,-5730,0.86
 2019,Taylor,GA,"Taylor, GA",33163,0,756,32400,763,1.02
 2020,Taylor,GA,"Taylor, GA",34501,4,739,31671,2830,1.09
 2021,Taylor,GA,"Taylor, GA",39030,13,753,32271,6759,1.21
 2019,Taylor,IA,"Taylor, IA",43591,0,411,17614,25977,2.47
 2020,Taylor,IA,"Taylor, IA",46861,8,446,19114,27747,2.45
 2021,Taylor,IA,"Taylor, IA",54870,17,386,16543,38327,3.32
 2019,Taylor,KY,"Taylor, KY",35200,0,663,28414,6786,1.24
 2020,Taylor,KY,"Taylor, KY",39022,11,719,30814,8208,1.27
 2021,Taylor,KY,"Taylor, KY",41752,7,1100,47143,-5391,0.89
 2019,Taylor,TX,"Taylor, TX",47295,0,1057,45300,1995,1.04
 2020,Taylor,TX,"Taylor, TX",51172,8,1070,45857,5315,1.12
 2021,Taylor,TX,"Taylor, TX",58316,14,1061,45471,12845,1.28
 2019,Taylor,WI,"Taylor, WI",42940,0,758,32486,10454,1.32
 2020,Taylor,WI,"Taylor, WI",47580,11,773,33129,14451,1.44
 2021,Taylor,WI,"Taylor, WI",49783,5,861,36900,12883,1.35
 2019,Taylor,WV,"Taylor, WV",42680,0,1187,50871,-8191,0.84
 2020,Taylor,WV,"Taylor, WV",43876,3,971,41614,2262,1.05
 2021,Taylor,WV,"Taylor, WV",47328,8,963,41271,6057,1.15
 2019,Tazewell,IL,"Tazewell, IL",48427,0,665,28500,19927,1.7
 2020,Tazewell,IL,"Tazewell, IL",52046,8,615,26357,25689,1.97
 2021,Tazewell,IL,"Tazewell, IL",54768,5,562,24086,30682,2.27
 2019,Tazewell,VA,"Tazewell, VA",37901,0,586,25114,12787,1.51
 2020,Tazewell,VA,"Tazewell, VA",40339,6,650,27857,12482,1.45
 2021,Tazewell,VA,"Tazewell, VA",43786,9,718,30771,13015,1.42
 2019,Tehama,CA,"Tehama, CA",40437,0,1528,65486,-25049,0.62
 2020,Tehama,CA,"Tehama, CA",45064,11,1482,63514,-18450,0.71
 2021,Tehama,CA,"Tehama, CA",48042,7,1888,80914,-32872,0.59
 2019,Telfair,GA,"Telfair, GA",25575,0,558,23914,1661,1.07
 2020,Telfair,GA,"Telfair, GA",28241,10,655,28071,170,1.01
 2021,Telfair,GA,"Telfair, GA",30573,8,1120,48000,-17427,0.64
 2019,Teller,CO,"Teller, CO",54000,0,1927,82586,-28586,0.65
 2020,Teller,CO,"Teller, CO",57928,7,2017,86443,-28515,0.67
 2021,Teller,CO,"Teller, CO",61966,7,2490,106714,-44748,0.58
 2019,Tensas,LA,"Tensas, LA",41300,0,1294,55457,-14157,0.74
 2020,Tensas,LA,"Tensas, LA",46399,12,1795,76929,-30530,0.6
 2021,Tensas,LA,"Tensas, LA",50669,9,659,28243,22426,1.79
 2019,Terrebonne,LA,"Terrebonne, LA",43385,0,886,37971,5414,1.14
 2020,Terrebonne,LA,"Terrebonne, LA",46751,8,931,39900,6851,1.17
 2021,Terrebonne,LA,"Terrebonne, LA",49612,6,1511,64757,-15145,0.77
 2019,Terrell,GA,"Terrell, GA",39352,0,441,18900,20452,2.08
 2020,Terrell,GA,"Terrell, GA",42819,9,491,21043,21776,2.03
 2021,Terrell,GA,"Terrell, GA",47258,10,613,26271,20987,1.8
 2019,Terrell,TX,"Terrell, TX",47492,0,427,18300,29192,2.6
 2020,Terrell,TX,"Terrell, TX",56833,20,378,16200,40633,3.51
 2021,Terrell,TX,"Terrell, TX",63481,12,537,23014,40467,2.76
 2019,Terry,TX,"Terry, TX",38147,0,705,30214,7933,1.26
 2020,Terry,TX,"Terry, TX",42626,12,680,29143,13483,1.46
 2021,Terry,TX,"Terry, TX",45353,6,926,39686,5667,1.14
 2019,Teton,ID,"Teton, ID",45088,0,2874,123171,-78083,0.37
 2020,Teton,ID,"Teton, ID",47705,6,2853,122271,-74566,0.39
 2021,Teton,ID,"Teton, ID",53564,12,6761,289757,-236193,0.18
 2019,Teton,MT,"Teton, MT",49178,0,873,37414,11764,1.31
 2020,Teton,MT,"Teton, MT",53825,9,1233,52843,982,1.02
 2021,Teton,MT,"Teton, MT",50240,-7,2281,97757,-47517,0.51
 2019,Teton,WY,"Teton, WY",278682,0,8530,365571,-86889,0.76
 2020,Teton,WY,"Teton, WY",290674,4,9518,407914,-117240,0.71
 2021,Teton,WY,"Teton, WY",318297,10,18292,783943,-465646,0.41
 2019,Texas,MO,"Texas, MO",30579,0,627,26871,3708,1.14
 2020,Texas,MO,"Texas, MO",34186,12,614,26314,7872,1.3
 2021,Texas,MO,"Texas, MO",35346,3,687,29443,5903,1.2
 2019,Texas,OK,"Texas, OK",52877,0,358,15343,37534,3.45
 2020,Texas,OK,"Texas, OK",51093,-3,518,22200,28893,2.3
 2021,Texas,OK,"Texas, OK",58194,14,1353,57986,208,1
 2019,Thayer,NE,"Thayer, NE",52792,0,1272,54514,-1722,0.97
 2020,Thayer,NE,"Thayer, NE",59847,13,515,22071,37776,2.71
 2021,Thayer,NE,"Thayer, NE",63828,7,740,31714,32114,2.01
 2019,Thomas,GA,"Thomas, GA",44358,0,1067,45729,-1371,0.97
 2020,Thomas,GA,"Thomas, GA",48175,9,1198,51343,-3168,0.94
 2021,Thomas,GA,"Thomas, GA",52349,9,1312,56229,-3880,0.93
 2019,Thomas,KS,"Thomas, KS",47126,0,808,34629,12497,1.36
 2020,Thomas,KS,"Thomas, KS",50599,7,768,32914,17685,1.54
 2021,Thomas,KS,"Thomas, KS",51579,2,731,31329,20250,1.65
 2019,Thomas,NE,"Thomas, NE",57707,0,456,19543,38164,2.95
 2021,Thomas,NE,"Thomas, NE",61324,2,899,38529,22795,1.59
 2019,Throckmorton,TX,"Throckmorton, TX",43729,0,575,24643,19086,1.77
 2020,Throckmorton,TX,"Throckmorton, TX",44690,2,357,15300,29390,2.92
 2021,Throckmorton,TX,"Throckmorton, TX",69390,55,671,28757,40633,2.41
 2019,Thurston,NE,"Thurston, NE",41718,0,719,30814,10904,1.35
 2020,Thurston,NE,"Thurston, NE",49998,20,436,18686,31312,2.68
 2021,Thurston,NE,"Thurston, NE",57406,15,975,41786,15620,1.37
 2019,Thurston,WA,"Thurston, WA",52297,0,1888,80914,-28617,0.65
 2020,Thurston,WA,"Thurston, WA",56527,8,1876,80400,-23873,0.7
 2021,Thurston,WA,"Thurston, WA",61062,8,2153,92271,-31209,0.66
 2019,Tift,GA,"Tift, GA",37892,0,825,35357,2535,1.07
 2020,Tift,GA,"Tift, GA",41415,9,861,36900,4515,1.12
 2021,Tift,GA,"Tift, GA",44913,8,943,40414,4499,1.11
 2019,Tillamook,OR,"Tillamook, OR",45064,0,1942,83229,-38165,0.54
 2020,Tillamook,OR,"Tillamook, OR",48609,8,1911,81900,-33291,0.59
 2021,Tillamook,OR,"Tillamook, OR",51643,6,2270,97286,-45643,0.53
 2019,Tillman,OK,"Tillman, OK",38397,0,286,12257,26140,3.13
 2020,Tillman,OK,"Tillman, OK",37561,-2,295,12643,24918,2.97
 2021,Tillman,OK,"Tillman, OK",40610,8,621,26614,13996,1.53
 2019,Tioga,NY,"Tioga, NY",46710,0,639,27386,19324,1.71
 2020,Tioga,NY,"Tioga, NY",50803,9,727,31157,19646,1.63
 2021,Tioga,NY,"Tioga, NY",53919,6,689,29529,24390,1.83
 2019,Tioga,PA,"Tioga, PA",41371,0,703,30129,11242,1.37
 2020,Tioga,PA,"Tioga, PA",44366,7,760,32571,11795,1.36
 2021,Tioga,PA,"Tioga, PA",47572,7,858,36771,10801,1.29
 2019,Tippah,MS,"Tippah, MS",38433,0,753,32271,6162,1.19
 2020,Tippah,MS,"Tippah, MS",42300,10,795,34071,8229,1.24
 2021,Tippah,MS,"Tippah, MS",44301,5,817,35014,9287,1.27
 2019,Tippecanoe,IN,"Tippecanoe, IN",41299,0,1124,48171,-6872,0.86
 2020,Tippecanoe,IN,"Tippecanoe, IN",43243,5,1351,57900,-14657,0.75
 2021,Tippecanoe,IN,"Tippecanoe, IN",45950,6,1185,50786,-4836,0.9
 2019,Tipton,IN,"Tipton, IN",45677,0,610,26143,19534,1.75
 2020,Tipton,IN,"Tipton, IN",48982,7,416,17829,31153,2.75
 2021,Tipton,IN,"Tipton, IN",51881,6,668,28629,23252,1.81
 2019,Tipton,TN,"Tipton, TN",41866,0,876,37543,4323,1.12
 2020,Tipton,TN,"Tipton, TN",44778,7,975,41786,2992,1.07
 2021,Tipton,TN,"Tipton, TN",49219,10,1278,54771,-5552,0.9
 2019,Tishomingo,MS,"Tishomingo, MS",35811,0,946,40543,-4732,0.88
 2020,Tishomingo,MS,"Tishomingo, MS",38796,8,866,37114,1682,1.05
 2021,Tishomingo,MS,"Tishomingo, MS",41457,7,1116,47829,-6372,0.87
 2019,Titus,TX,"Titus, TX",39180,0,1118,47914,-8734,0.82
 2020,Titus,TX,"Titus, TX",43404,11,1110,47571,-4167,0.91
 2021,Titus,TX,"Titus, TX",48007,11,1381,59186,-11179,0.81
 2019,Todd,KY,"Todd, KY",39044,0,673,28843,10201,1.35
 2020,Todd,KY,"Todd, KY",41776,7,684,29314,12462,1.43
 2021,Todd,KY,"Todd, KY",46946,12,1064,45600,1346,1.03
 2019,Todd,MN,"Todd, MN",42688,0,821,35186,7502,1.21
 2020,Todd,MN,"Todd, MN",43743,3,740,31714,12029,1.38
 2021,Todd,MN,"Todd, MN",47069,8,927,39729,7340,1.18
 2019,Todd,SD,"Todd, SD",28052,0,772,33086,-5034,0.85
 2020,Todd,SD,"Todd, SD",31093,11,564,24171,6922,1.29
 2021,Todd,SD,"Todd, SD",35663,15,335,14357,21306,2.48
 2019,Tom Green,TX,"Tom Green, TX",52033,0,1069,45814,6219,1.14
 2020,Tom Green,TX,"Tom Green, TX",55927,8,1237,53014,2913,1.05
 2021,Tom Green,TX,"Tom Green, TX",59877,7,1259,53957,5920,1.11
 2019,Tompkins,NY,"Tompkins, NY",45232,0,1174,50314,-5082,0.9
 2020,Tompkins,NY,"Tompkins, NY",48541,7,1285,55071,-6530,0.88
 2021,Tompkins,NY,"Tompkins, NY",51377,6,1341,57471,-6094,0.89
 2019,Tooele,UT,"Tooele, UT",39109,0,1572,67371,-28262,0.58
 2020,Tooele,UT,"Tooele, UT",42321,8,1690,72429,-30108,0.58
 2021,Tooele,UT,"Tooele, UT",46131,9,1816,77829,-31698,0.59
 2019,Toole,MT,"Toole, MT",49222,0,675,28929,20293,1.7
 2020,Toole,MT,"Toole, MT",54000,10,539,23100,30900,2.34
 2021,Toole,MT,"Toole, MT",49135,-9,594,25457,23678,1.93
 2019,Toombs,GA,"Toombs, GA",35389,0,700,30000,5389,1.18
 2020,Toombs,GA,"Toombs, GA",39359,11,708,30343,9016,1.3
 2021,Toombs,GA,"Toombs, GA",42075,7,1009,43243,-1168,0.97
 2019,Torrance,NM,"Torrance, NM",34471,0,1130,48429,-13958,0.71
 2020,Torrance,NM,"Torrance, NM",38437,12,961,41186,-2749,0.93
 2021,Torrance,NM,"Torrance, NM",41423,8,1062,45514,-4091,0.91
 2019,Towner,ND,"Towner, ND",58502,0,709,30386,28116,1.93
 2020,Towner,ND,"Towner, ND",86111,47,620,26571,59540,3.24
 2021,Towner,ND,"Towner, ND",80665,-6,499,21386,59279,3.77
 2019,Towns,GA,"Towns, GA",40709,0,1455,62357,-21648,0.65
 2020,Towns,GA,"Towns, GA",43802,8,1492,63943,-20141,0.69
 2021,Towns,GA,"Towns, GA",45939,5,2070,88714,-42775,0.52
 2019,Traill,ND,"Traill, ND",54988,0,866,37114,17874,1.48
 2020,Traill,ND,"Traill, ND",64735,18,698,29914,34821,2.16
 2021,Traill,ND,"Traill, ND",65364,1,703,30129,35235,2.17
 2019,Transylvania,NC,"Transylvania, NC",45984,0,2070,88714,-42730,0.52
 2020,Transylvania,NC,"Transylvania, NC",48341,5,2095,89786,-41445,0.54
 2021,Transylvania,NC,"Transylvania, NC",52252,8,3586,153686,-101434,0.34
 2019,Traverse,MN,"Traverse, MN",49390,0,253,10843,38547,4.56
 2020,Traverse,MN,"Traverse, MN",68763,39,307,13157,55606,5.23
 2021,Traverse,MN,"Traverse, MN",73574,7,445,19071,54503,3.86
 2019,Travis,TX,"Travis, TX",73299,0,1970,84429,-11130,0.87
 2020,Travis,TX,"Travis, TX",73982,1,2176,93257,-19275,0.79
 2021,Travis,TX,"Travis, TX",81708,10,2587,110871,-29163,0.74
 2019,Treasure,MT,"Treasure, MT",51812,0,938,40200,11612,1.29
 2020,Treasure,MT,"Treasure, MT",56527,9,952,40800,15727,1.39
 2021,Treasure,MT,"Treasure, MT",49706,-12,1838,78771,-29065,0.63
 2019,Trego,KS,"Trego, KS",48789,0,376,16114,32675,3.03
 2020,Trego,KS,"Trego, KS",56758,16,412,17657,39101,3.21
 2021,Trego,KS,"Trego, KS",61938,9,636,27257,34681,2.27
 2019,Trempealeau,WI,"Trempealeau, WI",43745,0,926,39686,4059,1.1
 2020,Trempealeau,WI,"Trempealeau, WI",46772,7,1002,42943,3829,1.09
 2021,Trempealeau,WI,"Trempealeau, WI",49712,6,1179,50529,-817,0.98
 2019,Treutlen,GA,"Treutlen, GA",31609,0,507,21729,9880,1.45
 2020,Treutlen,GA,"Treutlen, GA",34542,9,795,34071,471,1.01
 2021,Treutlen,GA,"Treutlen, GA",38090,10,1211,51900,-13810,0.73
 2019,Trigg,KY,"Trigg, KY",40074,0,897,38443,1631,1.04
 2020,Trigg,KY,"Trigg, KY",43726,9,1163,49843,-6117,0.88
 2021,Trigg,KY,"Trigg, KY",47026,8,1245,53357,-6331,0.88
 2019,Trimble,KY,"Trimble, KY",40013,0,734,31457,8556,1.27
 2020,Trimble,KY,"Trimble, KY",43854,10,950,40714,3140,1.08
 2021,Trimble,KY,"Trimble, KY",47815,9,1090,46714,1101,1.02
 2019,Trinity,CA,"Trinity, CA",32079,0,1468,62914,-30835,0.51
 2020,Trinity,CA,"Trinity, CA",34293,7,1607,68871,-34578,0.5
 2021,Trinity,CA,"Trinity, CA",36906,8,2318,99343,-62437,0.37
 2019,Trinity,TX,"Trinity, TX",41668,0,658,28200,13468,1.48
 2020,Trinity,TX,"Trinity, TX",44332,6,745,31929,12403,1.39
 2021,Trinity,TX,"Trinity, TX",47101,6,903,38700,8401,1.22
 2019,Tripp,SD,"Tripp, SD",47916,0,1023,43843,4073,1.09
 2020,Tripp,SD,"Tripp, SD",53339,11,847,36300,17039,1.47
 2021,Tripp,SD,"Tripp, SD",60022,13,911,39043,20979,1.54
 2019,Troup,GA,"Troup, GA",37690,0,1016,43543,-5853,0.87
 2020,Troup,GA,"Troup, GA",41915,11,934,40029,1886,1.05
 2021,Troup,GA,"Troup, GA",45441,8,1132,48514,-3073,0.94
 2019,Trousdale,TN,"Trousdale, TN",31874,0,1116,47829,-15955,0.67
 2020,Trousdale,TN,"Trousdale, TN",33321,5,1464,62743,-29422,0.53
 2021,Trousdale,TN,"Trousdale, TN",36454,9,1882,80657,-44203,0.45
 2019,Trumbull,OH,"Trumbull, OH",40338,0,505,21643,18695,1.86
 2020,Trumbull,OH,"Trumbull, OH",43700,8,460,19714,23986,2.22
 2021,Trumbull,OH,"Trumbull, OH",46356,6,633,27129,19227,1.71
 2019,Tucker,WV,"Tucker, WV",44161,0,1018,43629,532,1.01
 2020,Tucker,WV,"Tucker, WV",48388,10,1156,49543,-1155,0.98
 2021,Tucker,WV,"Tucker, WV",52251,8,1401,60043,-7792,0.87
 2019,Tulare,CA,"Tulare, CA",40061,0,1289,55243,-15182,0.73
 2020,Tulare,CA,"Tulare, CA",45556,14,1288,55200,-9644,0.83
 2021,Tulare,CA,"Tulare, CA",47986,5,1804,77314,-29328,0.62
 2019,Tulsa,OK,"Tulsa, OK",63538,0,1147,49157,14381,1.29
 2020,Tulsa,OK,"Tulsa, OK",62889,-1,1332,57086,5803,1.1
 2021,Tulsa,OK,"Tulsa, OK",66535,6,1297,55586,10949,1.2
 2019,Tunica,MS,"Tunica, MS",33864,0,650,27857,6007,1.22
 2020,Tunica,MS,"Tunica, MS",39893,18,688,29486,10407,1.35
 2021,Tunica,MS,"Tunica, MS",41904,5,710,30429,11475,1.38
 2019,Tuolumne,CA,"Tuolumne, CA",46104,0,1598,68486,-22382,0.67
 2020,Tuolumne,CA,"Tuolumne, CA",49622,8,1594,68314,-18692,0.73
 2021,Tuolumne,CA,"Tuolumne, CA",52306,5,2166,92829,-40523,0.56
 2019,Turner,GA,"Turner, GA",32210,0,646,27686,4524,1.16
 2020,Turner,GA,"Turner, GA",34612,8,465,19929,14683,1.74
 2021,Turner,GA,"Turner, GA",38250,11,1150,49286,-11036,0.78
 2019,Turner,SD,"Turner, SD",61701,0,627,26871,34830,2.3
 2020,Turner,SD,"Turner, SD",63596,3,855,36643,26953,1.74
 2021,Turner,SD,"Turner, SD",73093,15,963,41271,31822,1.77
 2019,Tuscaloosa,AL,"Tuscaloosa, AL",37898,0,1052,45086,-7188,0.84
 2020,Tuscaloosa,AL,"Tuscaloosa, AL",40463,7,1144,49029,-8566,0.83
 2021,Tuscaloosa,AL,"Tuscaloosa, AL",43439,7,1264,54171,-10732,0.8
 2019,Tuscarawas,OH,"Tuscarawas, OH",44215,0,637,27300,16915,1.62
 2020,Tuscarawas,OH,"Tuscarawas, OH",47139,7,741,31757,15382,1.48
 2021,Tuscarawas,OH,"Tuscarawas, OH",50625,7,830,35571,15054,1.42
 2019,Tuscola,MI,"Tuscola, MI",37522,0,562,24086,13436,1.56
 2020,Tuscola,MI,"Tuscola, MI",42155,12,602,25800,16355,1.63
 2021,Tuscola,MI,"Tuscola, MI",44908,7,773,33129,11779,1.36
 2019,Twiggs,GA,"Twiggs, GA",39395,0,394,16886,22509,2.33
 2020,Twiggs,GA,"Twiggs, GA",41800,6,425,18214,23586,2.29
 2021,Twiggs,GA,"Twiggs, GA",44235,6,793,33986,10249,1.3
 2019,Twin Falls,ID,"Twin Falls, ID",40339,0,1242,53229,-12890,0.76
 2020,Twin Falls,ID,"Twin Falls, ID",43429,8,1326,56829,-13400,0.76
 2021,Twin Falls,ID,"Twin Falls, ID",45627,5,1776,76114,-30487,0.6
 2019,Tyler,TX,"Tyler, TX",36234,0,634,27171,9063,1.33
 2020,Tyler,TX,"Tyler, TX",39764,10,671,28757,11007,1.38
 2021,Tyler,TX,"Tyler, TX",41613,5,905,38786,2827,1.07
 2019,Tyler,WV,"Tyler, WV",42765,0,534,22886,19879,1.87
 2020,Tyler,WV,"Tyler, WV",43944,3,741,31757,12187,1.38
 2021,Tyler,WV,"Tyler, WV",47802,9,479,20529,27273,2.33
 2019,Tyrrell,NC,"Tyrrell, NC",39263,0,851,36471,2792,1.08
 2020,Tyrrell,NC,"Tyrrell, NC",43515,11,892,38229,5286,1.14
 2021,Tyrrell,NC,"Tyrrell, NC",47379,9,1756,75257,-27878,0.63
 2019,Uinta,WY,"Uinta, WY",41297,0,971,41614,-317,0.99
 2020,Uinta,WY,"Uinta, WY",42704,3,980,42000,704,1.02
 2021,Uinta,WY,"Uinta, WY",44157,3,1255,53786,-9629,0.82
 2019,Uintah,UT,"Uintah, UT",32029,0,924,39600,-7571,0.81
 2020,Uintah,UT,"Uintah, UT",33201,4,1033,44271,-11070,0.75
 2021,Uintah,UT,"Uintah, UT",35128,6,1516,64971,-29843,0.54
 2019,Ulster,NY,"Ulster, NY",53426,0,1424,61029,-7603,0.88
 2020,Ulster,NY,"Ulster, NY",57057,7,1578,67629,-10572,0.84
 2021,Ulster,NY,"Ulster, NY",60557,6,1972,84514,-23957,0.72
 2019,Umatilla,OR,"Umatilla, OR",40364,0,1172,50229,-9865,0.8
 2020,Umatilla,OR,"Umatilla, OR",44604,11,1233,52843,-8239,0.84
 2021,Umatilla,OR,"Umatilla, OR",48439,9,1395,59786,-11347,0.81
 2019,Unicoi,TN,"Unicoi, TN",37049,0,815,34929,2120,1.06
 2020,Unicoi,TN,"Unicoi, TN",39632,7,913,39129,503,1.01
 2021,Unicoi,TN,"Unicoi, TN",43044,9,1286,55114,-12070,0.78
 2019,Union,AR,"Union, AR",45295,0,744,31886,13409,1.42
 2020,Union,AR,"Union, AR",47422,5,708,30343,17079,1.56
 2021,Union,AR,"Union, AR",50787,7,888,38057,12730,1.33
 2019,Union,FL,"Union, FL",21387,0,1148,49200,-27813,0.43
 2020,Union,FL,"Union, FL",23094,8,1497,64157,-41063,0.36
 2021,Union,FL,"Union, FL",25293,10,1472,63086,-37793,0.4
 2019,Union,GA,"Union, GA",40040,0,1360,58286,-18246,0.69
 2020,Union,GA,"Union, GA",42125,5,1455,62357,-20232,0.68
 2021,Union,GA,"Union, GA",44163,5,1966,84257,-40094,0.52
 2019,Union,IA,"Union, IA",41442,0,622,26657,14785,1.55
 2020,Union,IA,"Union, IA",43838,6,493,21129,22709,2.07
 2021,Union,IA,"Union, IA",48291,10,558,23914,24377,2.02
 2019,Union,IL,"Union, IL",41799,0,481,20614,21185,2.03
 2020,Union,IL,"Union, IL",46260,11,645,27643,18617,1.67
 2021,Union,IL,"Union, IL",49595,7,577,24729,24866,2.01
 2019,Union,IN,"Union, IN",39262,0,393,16843,22419,2.33
 2020,Union,IN,"Union, IN",43019,10,363,15557,27462,2.77
 2021,Union,IN,"Union, IN",47359,10,1033,44271,3088,1.07
 2019,Union,KY,"Union, KY",38529,0,523,22414,16115,1.72
 2020,Union,KY,"Union, KY",43417,13,516,22114,21303,1.96
 2021,Union,KY,"Union, KY",49499,14,663,28414,21085,1.74
 2019,Union,LA,"Union, LA",42278,0,764,32743,9535,1.29
 2020,Union,LA,"Union, LA",45030,7,901,38614,6416,1.17
 2021,Union,LA,"Union, LA",49647,10,1636,70114,-20467,0.71
 2019,Union,MS,"Union, MS",35412,0,891,38186,-2774,0.93
 2020,Union,MS,"Union, MS",38697,9,1066,45686,-6989,0.85
 2021,Union,MS,"Union, MS",41155,6,1385,59357,-18202,0.69
 2019,Union,NC,"Union, NC",55973,0,1801,77186,-21213,0.73
 2020,Union,NC,"Union, NC",59055,6,1762,75514,-16459,0.78
 2021,Union,NC,"Union, NC",63777,8,2134,91457,-27680,0.7
 2019,Union,NJ,"Union, NJ",68555,0,1862,79800,-11245,0.86
 2020,Union,NJ,"Union, NJ",70955,4,1997,85586,-14631,0.83
 2021,Union,NJ,"Union, NJ",77007,9,2085,89357,-12350,0.86
 2019,Union,NM,"Union, NM",35867,0,379,16243,19624,2.21
 2020,Union,NM,"Union, NM",40294,12,317,13586,26708,2.97
 2021,Union,NM,"Union, NM",41350,3,472,20229,21121,2.04
 2019,Union,OH,"Union, OH",58178,0,2008,86057,-27879,0.68
 2020,Union,OH,"Union, OH",61633,6,1937,83014,-21381,0.74
 2021,Union,OH,"Union, OH",64967,5,2163,92700,-27733,0.7
 2019,Union,OR,"Union, OR",42107,0,1331,57043,-14936,0.74
 2020,Union,OR,"Union, OR",46076,9,1114,47743,-1667,0.97
 2021,Union,OR,"Union, OR",50053,9,1357,58157,-8104,0.86
 2019,Union,PA,"Union, PA",44452,0,1194,51171,-6719,0.87
 2020,Union,PA,"Union, PA",47782,8,1365,58500,-10718,0.82
 2021,Union,PA,"Union, PA",50630,6,1464,62743,-12113,0.81
 2019,Union,SC,"Union, SC",34503,0,544,23314,11189,1.48
 2020,Union,SC,"Union, SC",37527,9,580,24857,12670,1.51
 2021,Union,SC,"Union, SC",40821,9,712,30514,10307,1.34
 2019,Union,SD,"Union, SD",118994,0,1599,68529,50465,1.74
 2020,Union,SD,"Union, SD",125786,6,1639,70243,55543,1.79
 2021,Union,SD,"Union, SD",134811,7,1335,57214,77597,2.36
 2019,Union,TN,"Union, TN",34493,0,1178,50486,-15993,0.68
 2020,Union,TN,"Union, TN",36826,7,1129,48386,-11560,0.76
 2021,Union,TN,"Union, TN",40349,10,1686,72257,-31908,0.56
 2019,Upshur,TX,"Upshur, TX",39605,0,821,35186,4419,1.13
 2020,Upshur,TX,"Upshur, TX",40755,3,870,37286,3469,1.09
 2021,Upshur,TX,"Upshur, TX",43308,6,890,38143,5165,1.14
 2019,Upshur,WV,"Upshur, WV",36416,0,869,37243,-827,0.98
 2020,Upshur,WV,"Upshur, WV",38085,5,766,32829,5256,1.16
 2021,Upshur,WV,"Upshur, WV",40187,6,761,32614,7573,1.23
 2019,Upson,GA,"Upson, GA",35635,0,729,31243,4392,1.14
 2020,Upson,GA,"Upson, GA",38329,8,707,30300,8029,1.26
 2021,Upson,GA,"Upson, GA",42364,11,939,40243,2121,1.05
 2019,Upton,TX,"Upton, TX",51233,0,705,30214,21019,1.7
 2020,Upton,TX,"Upton, TX",55500,8,565,24214,31286,2.29
 2021,Upton,TX,"Upton, TX",61595,11,603,25843,35752,2.38
 2019,Utah,UT,"Utah, UT",44079,0,1870,80143,-36064,0.55
 2020,Utah,UT,"Utah, UT",47232,7,2033,87129,-39897,0.54
 2021,Utah,UT,"Utah, UT",50661,7,2554,109457,-58796,0.46
 2019,Uvalde,TX,"Uvalde, TX",44957,0,1029,44100,857,1.02
 2020,Uvalde,TX,"Uvalde, TX",48807,9,1272,54514,-5707,0.9
 2021,Uvalde,TX,"Uvalde, TX",53257,9,1471,63043,-9786,0.84
 2019,Val Verde,TX,"Val Verde, TX",39906,0,883,37843,2063,1.05
 2020,Val Verde,TX,"Val Verde, TX",42532,7,843,36129,6403,1.18
 2021,Val Verde,TX,"Val Verde, TX",46642,10,980,42000,4642,1.11
 2019,Valencia,NM,"Valencia, NM",36192,0,1004,43029,-6837,0.84
 2020,Valencia,NM,"Valencia, NM",39980,11,1114,47743,-7763,0.84
 2021,Valencia,NM,"Valencia, NM",43485,9,1348,57771,-14286,0.75
 2019,Valley,ID,"Valley, ID",51861,0,1545,66214,-14353,0.78
 2020,Valley,ID,"Valley, ID",55295,7,2027,86871,-31576,0.64
 2021,Valley,ID,"Valley, ID",57895,5,4597,197014,-139119,0.29
 2019,Valley,MT,"Valley, MT",46099,0,1066,45686,413,1.01
 2020,Valley,MT,"Valley, MT",50260,9,904,38743,11517,1.3
 2021,Valley,MT,"Valley, MT",56541,13,705,30214,26327,1.87
 2019,Valley,NE,"Valley, NE",52167,0,252,10800,41367,4.83
 2020,Valley,NE,"Valley, NE",60546,16,524,22457,38089,2.7
 2021,Valley,NE,"Valley, NE",63254,5,1054,45171,18083,1.4
 2019,Van Buren,AR,"Van Buren, AR",32935,0,546,23400,9535,1.41
 2020,Van Buren,AR,"Van Buren, AR",35870,9,613,26271,9599,1.37
 2021,Van Buren,AR,"Van Buren, AR",38783,8,753,32271,6512,1.2
 2019,Van Buren,IA,"Van Buren, IA",40622,0,624,26743,13879,1.52
 2020,Van Buren,IA,"Van Buren, IA",42312,4,422,18086,24226,2.34
 2021,Van Buren,IA,"Van Buren, IA",47655,13,456,19543,28112,2.44
 2019,Van Buren,MI,"Van Buren, MI",41782,0,1136,48686,-6904,0.86
 2020,Van Buren,MI,"Van Buren, MI",45781,10,1239,53100,-7319,0.86
 2021,Van Buren,MI,"Van Buren, MI",48770,7,1321,56614,-7844,0.86
 2019,Van Buren,TN,"Van Buren, TN",31881,0,1410,60429,-28548,0.53
 2020,Van Buren,TN,"Van Buren, TN",34664,9,1224,52457,-17793,0.66
 2021,Van Buren,TN,"Van Buren, TN",36669,6,2353,100843,-64174,0.36
 2019,Van Wert,OH,"Van Wert, OH",42094,0,446,19114,22980,2.2
 2020,Van Wert,OH,"Van Wert, OH",46137,10,530,22714,23423,2.03
 2021,Van Wert,OH,"Van Wert, OH",49328,7,684,29314,20014,1.68
 2019,Vance,NC,"Vance, NC",36561,0,611,26186,10375,1.4
 2020,Vance,NC,"Vance, NC",39845,9,808,34629,5216,1.15
 2021,Vance,NC,"Vance, NC",44399,11,809,34671,9728,1.28
 2019,Venango,PA,"Venango, PA",43572,0,436,18686,24886,2.33
 2020,Venango,PA,"Venango, PA",47240,8,444,19029,28211,2.48
 2021,Venango,PA,"Venango, PA",50691,7,472,20229,30462,2.51
 2019,Ventura,CA,"Ventura, CA",63833,0,3289,140957,-77124,0.45
 2020,Ventura,CA,"Ventura, CA",68647,8,3825,163929,-95282,0.42
 2021,Ventura,CA,"Ventura, CA",73375,7,4235,181500,-108125,0.4
 2019,Vermilion,IL,"Vermilion, IL",40054,0,383,16414,23640,2.44
 2020,Vermilion,IL,"Vermilion, IL",44975,12,380,16286,28689,2.76
 2021,Vermilion,IL,"Vermilion, IL",49265,10,427,18300,30965,2.69
 2019,Vermilion,LA,"Vermilion, LA",41032,0,729,31243,9789,1.31
 2020,Vermilion,LA,"Vermilion, LA",43670,6,853,36557,7113,1.19
 2021,Vermilion,LA,"Vermilion, LA",46494,7,831,35614,10880,1.31
 2019,Vermillion,IN,"Vermillion, IN",37909,0,266,11400,26509,3.33
 2020,Vermillion,IN,"Vermillion, IN",41723,10,452,19371,22352,2.15
 2021,Vermillion,IN,"Vermillion, IN",45487,9,417,17871,27616,2.55
 2019,Vernon,LA,"Vernon, LA",41732,0,716,30686,11046,1.36
 2020,Vernon,LA,"Vernon, LA",44514,7,783,33557,10957,1.33
 2021,Vernon,LA,"Vernon, LA",47307,6,764,32743,14564,1.44
 2019,Vernon,MO,"Vernon, MO",36058,0,593,25414,10644,1.42
 2020,Vernon,MO,"Vernon, MO",40312,12,544,23314,16998,1.73
 2021,Vernon,MO,"Vernon, MO",42332,5,565,24214,18118,1.75
 2019,Vernon,WI,"Vernon, WI",42487,0,873,37414,5073,1.14
 2020,Vernon,WI,"Vernon, WI",45812,8,1050,45000,812,1.02
 2021,Vernon,WI,"Vernon, WI",49116,7,1226,52543,-3427,0.93
 2019,Victoria,TX,"Victoria, TX",53174,0,1127,48300,4874,1.1
 2020,Victoria,TX,"Victoria, TX",54194,2,1055,45214,8980,1.2
 2021,Victoria,TX,"Victoria, TX",58479,8,1288,55200,3279,1.06
 2019,Vigo,IN,"Vigo, IN",39159,0,452,19371,19788,2.02
 2020,Vigo,IN,"Vigo, IN",42511,9,472,20229,22282,2.1
 2021,Vigo,IN,"Vigo, IN",45767,8,701,30043,15724,1.52
 2019,Vilas,WI,"Vilas, WI",53083,0,1315,56357,-3274,0.94
 2020,Vilas,WI,"Vilas, WI",53617,1,1333,57129,-3512,0.94
 2021,Vilas,WI,"Vilas, WI",56041,5,1858,79629,-23588,0.7
 2019,Vinton,OH,"Vinton, OH",35464,0,773,33129,2335,1.07
 2020,Vinton,OH,"Vinton, OH",39672,12,637,27300,12372,1.45
 2021,Vinton,OH,"Vinton, OH",42290,7,1206,51686,-9396,0.82
 2019,Volusia,FL,"Volusia, FL",46612,0,1260,54000,-7388,0.86
 2020,Volusia,FL,"Volusia, FL",48620,4,1300,55714,-7094,0.87
 2021,Volusia,FL,"Volusia, FL",52964,9,1624,69600,-16636,0.76
 2019,Wabash,IL,"Wabash, IL",43157,0,463,19843,23314,2.17
 2020,Wabash,IL,"Wabash, IL",47397,10,513,21986,25411,2.16
 2021,Wabash,IL,"Wabash, IL",51743,9,457,19586,32157,2.64
 2019,Wabash,IN,"Wabash, IN",42830,0,479,20529,22301,2.09
 2020,Wabash,IN,"Wabash, IN",46803,9,574,24600,22203,1.9
 2021,Wabash,IN,"Wabash, IN",51300,10,714,30600,20700,1.68
 2019,Wabasha,MN,"Wabasha, MN",50078,0,1245,53357,-3279,0.94
 2020,Wabasha,MN,"Wabasha, MN",55622,11,1148,49200,6422,1.13
 2021,Wabasha,MN,"Wabasha, MN",58382,5,1259,53957,4425,1.08
 2019,Wabaunsee,KS,"Wabaunsee, KS",51977,0,947,40586,11391,1.28
 2020,Wabaunsee,KS,"Wabaunsee, KS",55142,6,823,35271,19871,1.56
 2021,Wabaunsee,KS,"Wabaunsee, KS",58400,6,1203,51557,6843,1.13
 2019,Wadena,MN,"Wadena, MN",39290,0,620,26571,12719,1.48
 2020,Wadena,MN,"Wadena, MN",43488,11,638,27343,16145,1.59
 2021,Wadena,MN,"Wadena, MN",46380,7,1326,56829,-10449,0.82
 2019,Wagoner,OK,"Wagoner, OK",43020,0,955,40929,2091,1.05
 2020,Wagoner,OK,"Wagoner, OK",45032,5,913,39129,5903,1.15
 2021,Wagoner,OK,"Wagoner, OK",47142,5,1292,55371,-8229,0.85
 2019,Wahkiakum,WA,"Wahkiakum, WA",45523,0,1600,68571,-23048,0.66
 2020,Wahkiakum,WA,"Wahkiakum, WA",48982,8,1846,79114,-30132,0.62
 2021,Wahkiakum,WA,"Wahkiakum, WA",52239,7,2182,93514,-41275,0.56
 2019,Wake,NC,"Wake, NC",62535,0,1924,82457,-19922,0.76
 2020,Wake,NC,"Wake, NC",66147,6,1953,83700,-17553,0.79
 2021,Wake,NC,"Wake, NC",71205,8,2219,95100,-23895,0.75
 2019,Wakulla,FL,"Wakulla, FL",39253,0,1112,47657,-8404,0.82
 2020,Wakulla,FL,"Wakulla, FL",41625,6,1187,50871,-9246,0.82
 2021,Wakulla,FL,"Wakulla, FL",45669,10,1570,67286,-21617,0.68
 2019,Waldo,ME,"Waldo, ME",44788,0,1198,51343,-6555,0.87
 2020,Waldo,ME,"Waldo, ME",48538,8,1372,58800,-10262,0.83
 2021,Waldo,ME,"Waldo, ME",51757,7,1631,69900,-18143,0.74
 2019,Walker,AL,"Walker, AL",41267,0,671,28757,12510,1.44
 2020,Walker,AL,"Walker, AL",43568,6,812,34800,8768,1.25
 2021,Walker,AL,"Walker, AL",47239,8,1123,48129,-890,0.98
 2019,Walker,GA,"Walker, GA",35186,0,857,36729,-1543,0.96
 2020,Walker,GA,"Walker, GA",37697,7,846,36257,1440,1.04
 2021,Walker,GA,"Walker, GA",40744,8,1143,48986,-8242,0.83
 2019,Walker,TX,"Walker, TX",30157,0,1027,44014,-13857,0.69
 2020,Walker,TX,"Walker, TX",31523,5,1040,44571,-13048,0.71
 2021,Walker,TX,"Walker, TX",33345,6,1201,51471,-18126,0.65
 2019,Walla Walla,WA,"Walla Walla, WA",46483,0,1651,70757,-24274,0.66
 2020,Walla Walla,WA,"Walla Walla, WA",50520,9,1918,82200,-31680,0.61
 2021,Walla Walla,WA,"Walla Walla, WA",53845,7,2186,93686,-39841,0.57
 2019,Wallace,KS,"Wallace, KS",51437,0,258,11057,40380,4.65
 2020,Wallace,KS,"Wallace, KS",59431,16,889,38100,21331,1.56
 2021,Wallace,KS,"Wallace, KS",61727,4,691,29614,32113,2.08
 2019,Waller,TX,"Waller, TX",45670,0,1638,70200,-24530,0.65
 2020,Waller,TX,"Waller, TX",47291,4,1687,72300,-25009,0.65
 2021,Waller,TX,"Waller, TX",49404,5,1941,83186,-33782,0.59
 2019,Wallowa,OR,"Wallowa, OR",44689,0,1913,81986,-37297,0.55
 2020,Wallowa,OR,"Wallowa, OR",48880,9,1757,75300,-26420,0.65
 2021,Wallowa,OR,"Wallowa, OR",52999,8,1971,84471,-31472,0.63
 2019,Walsh,ND,"Walsh, ND",50715,0,525,22500,28215,2.25
 2020,Walsh,ND,"Walsh, ND",61427,21,446,19114,42313,3.21
 2021,Walsh,ND,"Walsh, ND",65961,7,729,31243,34718,2.11
 2019,Walthall,MS,"Walthall, MS",33551,0,658,28200,5351,1.19
 2020,Walthall,MS,"Walthall, MS",35664,6,734,31457,4207,1.13
 2021,Walthall,MS,"Walthall, MS",39169,10,963,41271,-2102,0.95
 2019,Walton,FL,"Walton, FL",72175,0,2693,115414,-43239,0.63
 2020,Walton,FL,"Walton, FL",74926,4,3158,135343,-60417,0.55
 2021,Walton,FL,"Walton, FL",78714,5,3082,132086,-53372,0.6
 2019,Walton,GA,"Walton, GA",43227,0,1413,60557,-17330,0.71
 2020,Walton,GA,"Walton, GA",45718,6,1451,62186,-16468,0.74
 2021,Walton,GA,"Walton, GA",49062,7,1856,79543,-30481,0.62
 2019,Walworth,SD,"Walworth, SD",46362,0,430,18429,27933,2.52
 2020,Walworth,SD,"Walworth, SD",54683,18,501,21471,33212,2.55
 2021,Walworth,SD,"Walworth, SD",58681,7,639,27386,31295,2.14
 2019,Walworth,WI,"Walworth, WI",51483,0,1420,60857,-9374,0.85
 2020,Walworth,WI,"Walworth, WI",54477,6,1492,63943,-9466,0.85
 2021,Walworth,WI,"Walworth, WI",58208,7,1630,69857,-11649,0.83
 2019,Wapello,IA,"Wapello, IA",39029,0,512,21943,17086,1.78
 2020,Wapello,IA,"Wapello, IA",42551,9,637,27300,15251,1.56
 2021,Wapello,IA,"Wapello, IA",44912,6,486,20829,24083,2.16
 2019,Ward,ND,"Ward, ND",55233,0,996,42686,12547,1.29
 2020,Ward,ND,"Ward, ND",57047,3,943,40414,16633,1.41
 2021,Ward,ND,"Ward, ND",59893,5,1015,43500,16393,1.38
 2019,Ward,TX,"Ward, TX",56395,0,963,41271,15124,1.37
 2020,Ward,TX,"Ward, TX",49543,-12,988,42343,7200,1.17
 2021,Ward,TX,"Ward, TX",55099,11,1225,52500,2599,1.05
 2019,Ware,GA,"Ware, GA",33254,0,591,25329,7925,1.31
 2020,Ware,GA,"Ware, GA",36269,9,737,31586,4683,1.15
 2021,Ware,GA,"Ware, GA",38862,7,795,34071,4791,1.14
 2019,Warren,GA,"Warren, GA",36081,0,1008,43200,-7119,0.84
 2020,Warren,GA,"Warren, GA",40022,11,324,13886,26136,2.88
 2021,Warren,GA,"Warren, GA",42377,6,2230,95571,-53194,0.44
 2019,Warren,IA,"Warren, IA",52136,0,1385,59357,-7221,0.88
 2020,Warren,IA,"Warren, IA",54617,5,1282,54943,-326,0.99
 2021,Warren,IA,"Warren, IA",57847,6,1505,64500,-6653,0.9
 2019,Warren,IL,"Warren, IL",40380,0,432,18514,21866,2.18
 2020,Warren,IL,"Warren, IL",46032,14,437,18729,27303,2.46
 2021,Warren,IL,"Warren, IL",52506,14,478,20486,32020,2.56
 2019,Warren,IN,"Warren, IN",42880,0,681,29186,13694,1.47
 2020,Warren,IN,"Warren, IN",48047,12,551,23614,24433,2.03
 2021,Warren,IN,"Warren, IN",52196,9,707,30300,21896,1.72
 2019,Warren,KY,"Warren, KY",38686,0,1316,56400,-17714,0.69
 2020,Warren,KY,"Warren, KY",41516,7,1318,56486,-14970,0.73
 2021,Warren,KY,"Warren, KY",43812,6,1501,64329,-20517,0.68
 2019,Warren,MO,"Warren, MO",44910,0,898,38486,6424,1.17
 2020,Warren,MO,"Warren, MO",47227,5,945,40500,6727,1.17
 2021,Warren,MO,"Warren, MO",50001,6,1068,45771,4230,1.09
 2019,Warren,MS,"Warren, MS",41184,0,716,30686,10498,1.34
 2020,Warren,MS,"Warren, MS",44905,9,721,30900,14005,1.45
 2021,Warren,MS,"Warren, MS",48214,7,680,29143,19071,1.65
 2019,Warren,NC,"Warren, NC",31817,0,898,38486,-6669,0.83
 2020,Warren,NC,"Warren, NC",35682,12,1260,54000,-18318,0.66
 2021,Warren,NC,"Warren, NC",38740,9,2061,88329,-49589,0.44
 2019,Warren,NJ,"Warren, NJ",55865,0,1085,46500,9365,1.2
 2020,Warren,NJ,"Warren, NJ",58755,5,1299,55671,3084,1.06
 2021,Warren,NJ,"Warren, NJ",63041,7,1520,65143,-2102,0.97
 2019,Warren,NY,"Warren, NY",53919,0,1338,57343,-3424,0.94
 2020,Warren,NY,"Warren, NY",59267,10,1422,60943,-1676,0.97
 2021,Warren,NY,"Warren, NY",62392,5,1493,63986,-1594,0.98
 2019,Warren,OH,"Warren, OH",62927,0,1761,75471,-12544,0.83
 2020,Warren,OH,"Warren, OH",66080,5,1833,78557,-12477,0.84
 2021,Warren,OH,"Warren, OH",69581,5,2082,89229,-19648,0.78
 2019,Warren,PA,"Warren, PA",43634,0,414,17743,25891,2.46
 2020,Warren,PA,"Warren, PA",46945,8,310,13286,33659,3.53
 2021,Warren,PA,"Warren, PA",49356,5,611,26186,23170,1.88
 2019,Warren,TN,"Warren, TN",36188,0,936,40114,-3926,0.9
 2020,Warren,TN,"Warren, TN",38892,8,891,38186,706,1.02
 2021,Warren,TN,"Warren, TN",41296,6,1285,55071,-13775,0.75
 2019,Warren,VA,"Warren, VA",47404,0,1313,56271,-8867,0.84
 2020,Warren,VA,"Warren, VA",50644,7,1370,58714,-8070,0.86
 2021,Warren,VA,"Warren, VA",54290,7,1776,76114,-21824,0.71
 2019,Warrick,IN,"Warrick, IN",59014,0,1188,50914,8100,1.16
 2020,Warrick,IN,"Warrick, IN",61250,4,1090,46714,14536,1.31
 2021,Warrick,IN,"Warrick, IN",64880,6,1217,52157,12723,1.24
 2019,Wasatch,UT,"Wasatch, UT",63088,0,3634,155743,-92655,0.41
 2020,Wasatch,UT,"Wasatch, UT",66591,6,4039,173100,-106509,0.38
 2021,Wasatch,UT,"Wasatch, UT",71360,7,6458,276771,-205411,0.26
 2019,Wasco,OR,"Wasco, OR",43622,0,1531,65614,-21992,0.66
 2020,Wasco,OR,"Wasco, OR",48355,11,1648,70629,-22274,0.68
 2021,Wasco,OR,"Wasco, OR",52527,9,2333,99986,-47459,0.53
 2019,Waseca,MN,"Waseca, MN",41646,0,778,33343,8303,1.25
 2020,Waseca,MN,"Waseca, MN",47174,13,720,30857,16317,1.53
 2021,Waseca,MN,"Waseca, MN",50409,7,1023,43843,6566,1.15
 2019,Washakie,WY,"Washakie, WY",51388,0,830,35571,15817,1.44
 2020,Washakie,WY,"Washakie, WY",57228,11,720,30857,26371,1.85
 2021,Washakie,WY,"Washakie, WY",60235,5,1251,53614,6621,1.12
 2019,Washburn,WI,"Washburn, WI",47441,0,1136,48686,-1245,0.97
 2020,Washburn,WI,"Washburn, WI",50819,7,1013,43414,7405,1.17
 2021,Washburn,WI,"Washburn, WI",53835,6,1491,63900,-10065,0.84
 2019,Washington,AL,"Washington, AL",38414,0,810,34714,3700,1.11
 2020,Washington,AL,"Washington, AL",41642,8,709,30386,11256,1.37
 2021,Washington,AL,"Washington, AL",45956,10,1024,43886,2070,1.05
 2019,Washington,AR,"Washington, AR",41081,0,1252,53657,-12576,0.77
 2020,Washington,AR,"Washington, AR",44261,8,1370,58714,-14453,0.75
 2021,Washington,AR,"Washington, AR",47836,8,1672,71657,-23821,0.67
 2019,Washington,CO,"Washington, CO",39264,0,1000,42857,-3593,0.92
 2020,Washington,CO,"Washington, CO",41064,5,748,32057,9007,1.28
 2021,Washington,CO,"Washington, CO",48270,18,1235,52929,-4659,0.91
 2019,Washington,FL,"Washington, FL",31302,0,909,38957,-7655,0.8
 2020,Washington,FL,"Washington, FL",33656,8,1007,43157,-9501,0.78
 2021,Washington,FL,"Washington, FL",36331,8,1225,52500,-16169,0.69
 2019,Washington,GA,"Washington, GA",35531,0,631,27043,8488,1.31
 2020,Washington,GA,"Washington, GA",39048,10,550,23571,15477,1.66
 2021,Washington,GA,"Washington, GA",42068,8,1062,45514,-3446,0.92
 2019,Washington,IA,"Washington, IA",60809,0,774,33171,27638,1.83
 2020,Washington,IA,"Washington, IA",59627,-2,896,38400,21227,1.55
 2021,Washington,IA,"Washington, IA",65299,10,1014,43457,21842,1.5
 2019,Washington,ID,"Washington, ID",36859,0,1050,45000,-8141,0.82
 2020,Washington,ID,"Washington, ID",40441,10,1134,48600,-8159,0.83
 2021,Washington,ID,"Washington, ID",41119,2,1844,79029,-37910,0.52
 2019,Washington,IL,"Washington, IL",48833,0,626,26829,22004,1.82
 2020,Washington,IL,"Washington, IL",53581,10,687,29443,24138,1.82
 2021,Washington,IL,"Washington, IL",58419,9,766,32829,25590,1.78
 2019,Washington,IN,"Washington, IN",39427,0,662,28371,11056,1.39
 2020,Washington,IN,"Washington, IN",43081,9,646,27686,15395,1.56
 2021,Washington,IN,"Washington, IN",47858,11,972,41657,6201,1.15
 2019,Washington,KS,"Washington, KS",45422,0,376,16114,29308,2.82
 2020,Washington,KS,"Washington, KS",52942,17,279,11957,40985,4.43
 2021,Washington,KS,"Washington, KS",54905,4,1935,82929,-28024,0.66
 2019,Washington,KY,"Washington, KY",38865,0,805,34500,4365,1.13
 2020,Washington,KY,"Washington, KY",42401,9,691,29614,12787,1.43
 2021,Washington,KY,"Washington, KY",45807,8,1165,49929,-4122,0.92
 2019,Washington,LA,"Washington, LA",35745,0,733,31414,4331,1.14
 2020,Washington,LA,"Washington, LA",38878,9,786,33686,5192,1.15
 2021,Washington,LA,"Washington, LA",42225,9,1046,44829,-2604,0.94
 2019,Washington,MD,"Washington, MD",46141,0,1150,49286,-3145,0.94
 2020,Washington,MD,"Washington, MD",49510,7,1224,52457,-2947,0.94
 2021,Washington,MD,"Washington, MD",52897,7,1309,56100,-3203,0.94
 2019,Washington,ME,"Washington, ME",42051,0,774,33171,8880,1.27
 2020,Washington,ME,"Washington, ME",46891,12,788,33771,13120,1.39
 2021,Washington,ME,"Washington, ME",49280,5,1157,49586,-306,0.99
 2019,Washington,MN,"Washington, MN",69775,0,2135,91500,-21725,0.76
 2020,Washington,MN,"Washington, MN",72430,4,2133,91414,-18984,0.79
 2021,Washington,MN,"Washington, MN",76733,6,2194,94029,-17296,0.82
 2019,Washington,MO,"Washington, MO",31927,0,667,28586,3341,1.12
 2020,Washington,MO,"Washington, MO",34830,9,771,33043,1787,1.05
 2021,Washington,MO,"Washington, MO",37238,7,625,26786,10452,1.39
 2019,Washington,MS,"Washington, MS",36815,0,601,25757,11058,1.43
 2020,Washington,MS,"Washington, MS",41701,13,553,23700,18001,1.76
 2021,Washington,MS,"Washington, MS",45319,9,618,26486,18833,1.71
 2019,Washington,NC,"Washington, NC",38154,0,474,20314,17840,1.88
 2020,Washington,NC,"Washington, NC",41632,9,541,23186,18446,1.8
 2021,Washington,NC,"Washington, NC",46846,13,888,38057,8789,1.23
 2019,Washington,NE,"Washington, NE",58221,0,1559,66814,-8593,0.87
 2020,Washington,NE,"Washington, NE",61147,5,1351,57900,3247,1.06
 2021,Washington,NE,"Washington, NE",65143,7,1456,62400,2743,1.04
 2019,Washington,NY,"Washington, NY",42093,0,843,36129,5964,1.17
 2020,Washington,NY,"Washington, NY",46149,10,850,36429,9720,1.27
 2021,Washington,NY,"Washington, NY",49202,7,1118,47914,1288,1.03
 2019,Washington,OH,"Washington, OH",44669,0,776,33257,11412,1.34
 2020,Washington,OH,"Washington, OH",47691,7,826,35400,12291,1.35
 2021,Washington,OH,"Washington, OH",50549,6,947,40586,9963,1.25
 2019,Washington,OK,"Washington, OK",58893,0,640,27429,31464,2.15
 2020,Washington,OK,"Washington, OK",73262,24,706,30257,43005,2.42
 2021,Washington,OK,"Washington, OK",78103,7,701,30043,48060,2.6
 2019,Washington,OR,"Washington, OR",62493,0,2355,100929,-38436,0.62
 2020,Washington,OR,"Washington, OR",66270,6,2292,98229,-31959,0.67
 2021,Washington,OR,"Washington, OR",71537,8,2658,113914,-42377,0.63
 2019,Washington,PA,"Washington, PA",57447,0,800,34286,23161,1.68
 2020,Washington,PA,"Washington, PA",61945,8,972,41657,20288,1.49
 2021,Washington,PA,"Washington, PA",65452,6,983,42129,23323,1.55
 2019,Washington,RI,"Washington, RI",68280,0,2564,109886,-41606,0.62
 2020,Washington,RI,"Washington, RI",72917,7,2449,104957,-32040,0.69
 2021,Washington,RI,"Washington, RI",77855,7,3618,155057,-77202,0.5
 2019,Washington,TN,"Washington, TN",45144,0,1086,46543,-1399,0.97
 2020,Washington,TN,"Washington, TN",48475,7,1313,56271,-7796,0.86
 2021,Washington,TN,"Washington, TN",52089,8,1645,70500,-18411,0.74
 2019,Washington,TX,"Washington, TX",55865,0,1289,55243,622,1.01
 2020,Washington,TX,"Washington, TX",59063,6,1452,62229,-3166,0.95
 2021,Washington,TX,"Washington, TX",61295,4,1692,72514,-11219,0.85
 2019,Washington,UT,"Washington, UT",42732,0,1882,80657,-37925,0.53
 2020,Washington,UT,"Washington, UT",45178,6,2077,89014,-43836,0.51
 2021,Washington,UT,"Washington, UT",47162,4,3059,131100,-83938,0.36
 2019,Washington,VT,"Washington, VT",59995,0,1362,58371,1624,1.03
 2020,Washington,VT,"Washington, VT",65375,9,1464,62743,2632,1.04
 2021,Washington,VT,"Washington, VT",67529,3,1359,58243,9286,1.16
 2019,Washington,WI,"Washington, WI",59788,0,1433,61414,-1626,0.97
 2020,Washington,WI,"Washington, WI",62434,4,1507,64586,-2152,0.97
 2021,Washington,WI,"Washington, WI",66103,6,1678,71914,-5811,0.92
 2019,Washita,OK,"Washita, OK",36697,0,409,17529,19168,2.09
 2020,Washita,OK,"Washita, OK",38035,4,387,16586,21449,2.29
 2021,Washita,OK,"Washita, OK",40961,8,565,24214,16747,1.69
 2019,Washoe,NV,"Washoe, NV",62117,0,2100,90000,-27883,0.69
 2020,Washoe,NV,"Washoe, NV",65674,6,2436,104400,-38726,0.63
 2021,Washoe,NV,"Washoe, NV",71436,9,3010,129000,-57564,0.55
 2019,Washtenaw,MI,"Washtenaw, MI",61447,0,1925,82500,-21053,0.74
 2020,Washtenaw,MI,"Washtenaw, MI",64636,5,1847,79157,-14521,0.82
 2021,Washtenaw,MI,"Washtenaw, MI",68688,6,1953,83700,-15012,0.82
 2019,Watauga,NC,"Watauga, NC",40810,0,886,37971,2839,1.07
 2020,Watauga,NC,"Watauga, NC",43559,7,2089,89529,-45970,0.49
 2021,Watauga,NC,"Watauga, NC",46766,7,2831,121329,-74563,0.39
 2019,Watonwan,MN,"Watonwan, MN",44416,0,553,23700,20716,1.87
 2020,Watonwan,MN,"Watonwan, MN",50842,15,532,22800,28042,2.23
 2021,Watonwan,MN,"Watonwan, MN",55899,10,755,32357,23542,1.73
 2019,Waukesha,WI,"Waukesha, WI",74733,0,1917,82157,-7424,0.91
 2020,Waukesha,WI,"Waukesha, WI",77667,4,1917,82157,-4490,0.95
 2021,Waukesha,WI,"Waukesha, WI",82032,6,1944,83314,-1282,0.98
 2019,Waupaca,WI,"Waupaca, WI",46452,0,709,30386,16066,1.53
 2020,Waupaca,WI,"Waupaca, WI",49358,6,888,38057,11301,1.3
 2021,Waupaca,WI,"Waupaca, WI",52622,7,1034,44314,8308,1.19
 2019,Waushara,WI,"Waushara, WI",41912,0,851,36471,5441,1.15
 2020,Waushara,WI,"Waushara, WI",44479,6,811,34757,9722,1.28
 2021,Waushara,WI,"Waushara, WI",46929,6,1096,46971,-42,1
 2019,Wayne,GA,"Wayne, GA",32370,0,735,31500,870,1.03
 2020,Wayne,GA,"Wayne, GA",34619,7,918,39343,-4724,0.88
 2021,Wayne,GA,"Wayne, GA",37997,10,1116,47829,-9832,0.79
 2019,Wayne,IA,"Wayne, IA",42092,0,280,12000,30092,3.51
 2020,Wayne,IA,"Wayne, IA",45248,8,344,14743,30505,3.07
 2021,Wayne,IA,"Wayne, IA",50859,12,471,20186,30673,2.52
 2019,Wayne,IL,"Wayne, IL",39153,0,415,17786,21367,2.2
 2020,Wayne,IL,"Wayne, IL",43465,11,591,25329,18136,1.72
 2021,Wayne,IL,"Wayne, IL",48754,12,621,26614,22140,1.83
 2019,Wayne,IN,"Wayne, IN",41867,0,429,18386,23481,2.28
 2020,Wayne,IN,"Wayne, IN",45140,8,461,19757,25383,2.28
 2021,Wayne,IN,"Wayne, IN",48785,8,567,24300,24485,2.01
 2019,Wayne,KY,"Wayne, KY",30300,0,794,34029,-3729,0.89
 2020,Wayne,KY,"Wayne, KY",34737,15,860,36857,-2120,0.94
 2021,Wayne,KY,"Wayne, KY",38628,11,973,41700,-3072,0.93
 2019,Wayne,MI,"Wayne, MI",43271,0,547,23443,19828,1.85
 2020,Wayne,MI,"Wayne, MI",47533,10,571,24471,23062,1.94
 2021,Wayne,MI,"Wayne, MI",50610,7,710,30429,20181,1.66
 2019,Wayne,MO,"Wayne, MO",35865,0,529,22671,13194,1.58
 2020,Wayne,MO,"Wayne, MO",39972,12,473,20271,19701,1.97
 2021,Wayne,MO,"Wayne, MO",42678,7,695,29786,12892,1.43
 2019,Wayne,MS,"Wayne, MS",37296,0,555,23786,13510,1.57
 2020,Wayne,MS,"Wayne, MS",38401,3,633,27129,11272,1.42
 2021,Wayne,MS,"Wayne, MS",43439,13,701,30043,13396,1.45
 2019,Wayne,NC,"Wayne, NC",42187,0,850,36429,5758,1.16
 2020,Wayne,NC,"Wayne, NC",45415,8,924,39600,5815,1.15
 2021,Wayne,NC,"Wayne, NC",49881,10,913,39129,10752,1.27
 2019,Wayne,NE,"Wayne, NE",43613,0,683,29271,14342,1.49
 2020,Wayne,NE,"Wayne, NE",48187,11,773,33129,15058,1.45
 2021,Wayne,NE,"Wayne, NE",51852,8,1084,46457,5395,1.12
 2019,Wayne,NY,"Wayne, NY",47651,0,851,36471,11180,1.31
 2020,Wayne,NY,"Wayne, NY",51428,8,857,36729,14699,1.4
 2021,Wayne,NY,"Wayne, NY",53499,4,901,38614,14885,1.39
 2019,Wayne,OH,"Wayne, OH",46253,0,868,37200,9053,1.24
 2020,Wayne,OH,"Wayne, OH",49525,7,798,34200,15325,1.45
 2021,Wayne,OH,"Wayne, OH",52817,7,957,41014,11803,1.29
 2019,Wayne,PA,"Wayne, PA",45567,0,904,38743,6824,1.18
 2020,Wayne,PA,"Wayne, PA",49187,8,965,41357,7830,1.19
 2021,Wayne,PA,"Wayne, PA",52351,6,1418,60771,-8420,0.86
 2019,Wayne,TN,"Wayne, TN",30283,0,721,30900,-617,0.98
 2020,Wayne,TN,"Wayne, TN",33461,11,692,29657,3804,1.13
 2021,Wayne,TN,"Wayne, TN",35726,7,772,33086,2640,1.08
 2019,Wayne,UT,"Wayne, UT",45183,0,1533,65700,-20517,0.69
 2020,Wayne,UT,"Wayne, UT",50067,11,3205,137357,-87290,0.36
 2021,Wayne,UT,"Wayne, UT",52647,5,10152,435086,-382439,0.12
 2019,Wayne,WV,"Wayne, WV",35735,0,604,25886,9849,1.38
 2020,Wayne,WV,"Wayne, WV",37986,6,514,22029,15957,1.72
 2021,Wayne,WV,"Wayne, WV",41080,8,627,26871,14209,1.53
 2019,Weakley,TN,"Weakley, TN",38337,0,659,28243,10094,1.36
 2020,Weakley,TN,"Weakley, TN",41133,7,609,26100,15033,1.58
 2021,Weakley,TN,"Weakley, TN",45366,10,1109,47529,-2163,0.95
 2019,Webb,TX,"Webb, TX",34757,0,858,36771,-2014,0.95
 2020,Webb,TX,"Webb, TX",37273,7,902,38657,-1384,0.96
 2021,Webb,TX,"Webb, TX",40850,10,1080,46286,-5436,0.88
 2019,Weber,UT,"Weber, UT",43032,0,1818,77914,-34882,0.55
 2020,Weber,UT,"Weber, UT",46230,7,1808,77486,-31256,0.6
 2021,Weber,UT,"Weber, UT",49857,8,2076,88971,-39114,0.56
 2019,Webster,GA,"Webster, GA",38238,0,87,3729,34509,10.25
 2020,Webster,GA,"Webster, GA",41223,8,516,22114,19109,1.86
 2021,Webster,GA,"Webster, GA",43682,6,571,24471,19211,1.79
 2019,Webster,IA,"Webster, IA",45717,0,594,25457,20260,1.8
 2020,Webster,IA,"Webster, IA",47734,4,606,25971,21763,1.84
 2021,Webster,IA,"Webster, IA",51331,8,635,27214,24117,1.89
 2019,Webster,KY,"Webster, KY",39708,0,636,27257,12451,1.46
 2020,Webster,KY,"Webster, KY",41820,5,666,28543,13277,1.47
 2021,Webster,KY,"Webster, KY",48336,16,483,20700,27636,2.34
 2019,Webster,LA,"Webster, LA",42116,0,647,27729,14387,1.52
 2020,Webster,LA,"Webster, LA",46378,10,605,25929,20449,1.79
 2021,Webster,LA,"Webster, LA",49944,8,608,26057,23887,1.92
 2019,Webster,MO,"Webster, MO",34607,0,865,37071,-2464,0.93
 2020,Webster,MO,"Webster, MO",37195,8,1053,45129,-7934,0.82
 2021,Webster,MO,"Webster, MO",39976,8,1326,56829,-16853,0.7
 2019,Webster,MS,"Webster, MS",39308,0,721,30900,8408,1.27
 2020,Webster,MS,"Webster, MS",42236,7,861,36900,5336,1.14
 2021,Webster,MS,"Webster, MS",44543,6,867,37157,7386,1.2
 2019,Webster,NE,"Webster, NE",51108,0,1009,43243,7865,1.18
 2020,Webster,NE,"Webster, NE",54802,7,872,37371,17431,1.47
 2021,Webster,NE,"Webster, NE",57191,4,813,34843,22348,1.64
 2019,Webster,WV,"Webster, WV",29405,0,363,15557,13848,1.89
 2020,Webster,WV,"Webster, WV",32667,11,312,13371,19296,2.44
 2021,Webster,WV,"Webster, WV",34564,6,216,9257,25307,3.73
 2019,Weld,CO,"Weld, CO",50117,0,1911,81900,-31783,0.61
 2020,Weld,CO,"Weld, CO",52354,5,2045,87643,-35289,0.6
 2021,Weld,CO,"Weld, CO",56553,8,2306,98829,-42276,0.57
 2019,Wells,IN,"Wells, IN",42667,0,641,27471,15196,1.55
 2020,Wells,IN,"Wells, IN",45661,7,668,28629,17032,1.59
 2021,Wells,IN,"Wells, IN",49953,9,907,38871,11082,1.29
 2019,Wells,ND,"Wells, ND",58274,0,361,15471,42803,3.77
 2020,Wells,ND,"Wells, ND",76369,31,359,15386,60983,4.96
 2021,Wells,ND,"Wells, ND",82108,8,989,42386,39722,1.94
 2019,West Baton Rouge,LA,"West Baton Rouge, LA",48301,0,1159,49671,-1370,0.97
 2020,West Baton Rouge,LA,"West Baton Rouge, LA",51864,7,1171,50186,1678,1.03
 2021,West Baton Rouge,LA,"West Baton Rouge, LA",54404,5,1268,54343,61,1
 2019,West Carroll,LA,"West Carroll, LA",34982,0,437,18729,16253,1.87
 2020,West Carroll,LA,"West Carroll, LA",41431,18,345,14786,26645,2.8
 2021,West Carroll,LA,"West Carroll, LA",43241,4,697,29871,13370,1.45
 2019,West Feliciana,LA,"West Feliciana, LA",40309,0,1618,69343,-29034,0.58
 2020,West Feliciana,LA,"West Feliciana, LA",42753,6,1144,49029,-6276,0.87
 2021,West Feliciana,LA,"West Feliciana, LA",45199,6,2378,101914,-56715,0.44
 2019,Westchester,NY,"Westchester, NY",107755,0,3309,141814,-34059,0.76
 2020,Westchester,NY,"Westchester, NY",112096,4,3288,140914,-28818,0.8
 2021,Westchester,NY,"Westchester, NY",119705,7,2565,109929,9776,1.09
 2019,Weston,WY,"Weston, WY",46281,0,830,35571,10710,1.3
 2020,Weston,WY,"Weston, WY",47499,3,812,34800,12699,1.36
 2021,Weston,WY,"Weston, WY",49526,4,888,38057,11469,1.3
 2019,Wetzel,WV,"Wetzel, WV",38292,0,751,32186,6106,1.19
 2020,Wetzel,WV,"Wetzel, WV",39949,4,657,28157,11792,1.42
 2021,Wetzel,WV,"Wetzel, WV",43357,9,781,33471,9886,1.3
 2019,Wexford,MI,"Wexford, MI",37886,0,719,30814,7072,1.23
 2020,Wexford,MI,"Wexford, MI",41937,11,864,37029,4908,1.13
 2021,Wexford,MI,"Wexford, MI",44697,7,864,37029,7668,1.21
 2019,Wharton,TX,"Wharton, TX",46646,0,893,38271,8375,1.22
 2020,Wharton,TX,"Wharton, TX",48423,4,906,38829,9594,1.25
 2021,Wharton,TX,"Wharton, TX",52948,9,1107,47443,5505,1.12
 2019,Whatcom,WA,"Whatcom, WA",51683,0,2027,86871,-35188,0.59
 2020,Whatcom,WA,"Whatcom, WA",54927,6,2139,91671,-36744,0.6
 2021,Whatcom,WA,"Whatcom, WA",58137,6,2877,123300,-65163,0.47
 2019,Wheeler,GA,"Wheeler, GA",19726,0,571,24471,-4745,0.81
 2020,Wheeler,GA,"Wheeler, GA",22227,13,345,14786,7441,1.5
 2021,Wheeler,GA,"Wheeler, GA",24241,9,1019,43671,-19430,0.56
 2019,Wheeler,NE,"Wheeler, NE",73088,0,695,29786,43302,2.45
 2020,Wheeler,NE,"Wheeler, NE",72748,-1,463,19843,52905,3.67
 2021,Wheeler,NE,"Wheeler, NE",83722,15,783,33557,50165,2.49
 2019,Wheeler,OR,"Wheeler, OR",36225,0,1197,51300,-15075,0.71
 2020,Wheeler,OR,"Wheeler, OR",39648,9,1119,47957,-8309,0.83
 2021,Wheeler,OR,"Wheeler, OR",42637,8,1543,66129,-23492,0.64
 2019,Wheeler,TX,"Wheeler, TX",43274,0,413,17700,25574,2.44
 2020,Wheeler,TX,"Wheeler, TX",46553,8,369,15814,30739,2.94
 2021,Wheeler,TX,"Wheeler, TX",49906,7,582,24943,24963,2
 2019,White Pine,NV,"White Pine, NV",48628,0,594,25457,23171,1.91
 2020,White Pine,NV,"White Pine, NV",53734,11,676,28971,24763,1.85
 2021,White Pine,NV,"White Pine, NV",56241,5,889,38100,18141,1.48
 2019,White,AR,"White, AR",37253,0,669,28671,8582,1.3
 2020,White,AR,"White, AR",39958,7,670,28714,11244,1.39
 2021,White,AR,"White, AR",42743,7,852,36514,6229,1.17
 2019,White,GA,"White, GA",40768,0,964,41314,-546,0.99
 2020,White,GA,"White, GA",43695,7,1196,51257,-7562,0.85
 2021,White,GA,"White, GA",46899,7,1756,75257,-28358,0.62
 2019,White,IL,"White, IL",47588,0,417,17871,29717,2.66
 2020,White,IL,"White, IL",50024,5,365,15643,34381,3.2
 2021,White,IL,"White, IL",55372,11,394,16886,38486,3.28
 2019,White,IN,"White, IN",43407,0,797,34157,9250,1.27
 2020,White,IN,"White, IN",47617,10,827,35443,12174,1.34
 2021,White,IN,"White, IN",51422,8,978,41914,9508,1.23
 2019,White,TN,"White, TN",35019,0,834,35743,-724,0.98
 2020,White,TN,"White, TN",37603,7,962,41229,-3626,0.91
 2021,White,TN,"White, TN",40770,8,1447,62014,-21244,0.66
 2019,Whiteside,IL,"Whiteside, IL",43859,0,466,19971,23888,2.2
 2020,Whiteside,IL,"Whiteside, IL",48391,10,429,18386,30005,2.63
 2021,Whiteside,IL,"Whiteside, IL",52341,8,515,22071,30270,2.37
 2019,Whitfield,GA,"Whitfield, GA",40991,0,875,37500,3491,1.09
 2020,Whitfield,GA,"Whitfield, GA",44590,9,945,40500,4090,1.1
 2021,Whitfield,GA,"Whitfield, GA",47545,7,1198,51343,-3798,0.93
 2019,Whitley,IN,"Whitley, IN",47331,0,907,38871,8460,1.22
 2020,Whitley,IN,"Whitley, IN",50179,6,848,36343,13836,1.38
 2021,Whitley,IN,"Whitley, IN",53969,8,885,37929,16040,1.42
 2019,Whitley,KY,"Whitley, KY",34631,0,697,29871,4760,1.16
 2020,Whitley,KY,"Whitley, KY",38398,11,741,31757,6641,1.21
 2021,Whitley,KY,"Whitley, KY",42266,10,1111,47614,-5348,0.89
 2019,Whitman,WA,"Whitman, WA",40744,0,1352,57943,-17199,0.7
 2020,Whitman,WA,"Whitman, WA",44226,9,1367,58586,-14360,0.75
 2021,Whitman,WA,"Whitman, WA",46502,5,1641,70329,-23827,0.66
 2019,Wibaux,MT,"Wibaux, MT",41574,0,213,9129,32445,4.55
 2020,Wibaux,MT,"Wibaux, MT",45705,10,245,10500,35205,4.35
 2021,Wibaux,MT,"Wibaux, MT",48904,7,767,32871,16033,1.49
 2019,Wichita,KS,"Wichita, KS",60081,0,950,40714,19367,1.48
 2020,Wichita,KS,"Wichita, KS",58891,-2,761,32614,26277,1.81
 2021,Wichita,KS,"Wichita, KS",59792,2,364,15600,44192,3.83
 2019,Wichita,TX,"Wichita, TX",45009,0,630,27000,18009,1.67
 2020,Wichita,TX,"Wichita, TX",47089,5,628,26914,20175,1.75
 2021,Wichita,TX,"Wichita, TX",50210,7,775,33214,16996,1.51
 2019,Wicomico,MD,"Wicomico, MD",40580,0,926,39686,894,1.02
 2020,Wicomico,MD,"Wicomico, MD",43648,8,1061,45471,-1823,0.96
 2021,Wicomico,MD,"Wicomico, MD",46893,7,1226,52543,-5650,0.89
 2019,Wilbarger,TX,"Wilbarger, TX",51145,0,601,25757,25388,1.99
 2020,Wilbarger,TX,"Wilbarger, TX",53397,4,416,17829,35568,2.99
 2021,Wilbarger,TX,"Wilbarger, TX",59952,12,399,17100,42852,3.51
 2019,Wilcox,AL,"Wilcox, AL",33078,0,768,32914,164,1
 2020,Wilcox,AL,"Wilcox, AL",36742,11,874,37457,-715,0.98
 2021,Wilcox,AL,"Wilcox, AL",39354,7,1274,54600,-15246,0.72
 2019,Wilcox,GA,"Wilcox, GA",27763,0,469,20100,7663,1.38
 2020,Wilcox,GA,"Wilcox, GA",28996,4,496,21257,7739,1.36
 2021,Wilcox,GA,"Wilcox, GA",32288,11,1122,48086,-15798,0.67
 2019,Wilkes,GA,"Wilkes, GA",42207,0,1038,44486,-2279,0.95
 2020,Wilkes,GA,"Wilkes, GA",42864,2,1211,51900,-9036,0.83
 2021,Wilkes,GA,"Wilkes, GA",48806,14,1139,48814,-8,1
 2019,Wilkes,NC,"Wilkes, NC",38955,0,1023,43843,-4888,0.89
 2020,Wilkes,NC,"Wilkes, NC",41739,7,1256,53829,-12090,0.78
 2021,Wilkes,NC,"Wilkes, NC",46169,11,1337,57300,-11131,0.81
 2019,Wilkin,MN,"Wilkin, MN",48502,0,799,34243,14259,1.42
 2020,Wilkin,MN,"Wilkin, MN",58334,20,765,32786,25548,1.78
 2021,Wilkin,MN,"Wilkin, MN",65570,12,735,31500,34070,2.08
 2019,Wilkinson,GA,"Wilkinson, GA",36071,0,388,16629,19442,2.17
 2020,Wilkinson,GA,"Wilkinson, GA",40069,11,523,22414,17655,1.79
 2021,Wilkinson,GA,"Wilkinson, GA",42625,6,579,24814,17811,1.72
 2019,Wilkinson,MS,"Wilkinson, MS",30188,0,926,39686,-9498,0.76
 2020,Wilkinson,MS,"Wilkinson, MS",34316,14,687,29443,4873,1.17
 2021,Wilkinson,MS,"Wilkinson, MS",36890,8,742,31800,5090,1.16
 2019,Will,IL,"Will, IL",54695,0,1355,58071,-3376,0.94
 2020,Will,IL,"Will, IL",57813,6,1401,60043,-2230,0.96
 2021,Will,IL,"Will, IL",62272,8,1558,66771,-4499,0.93
 2019,Willacy,TX,"Willacy, TX",29395,0,826,35400,-6005,0.83
 2020,Willacy,TX,"Willacy, TX",32960,12,1163,49843,-16883,0.66
 2021,Willacy,TX,"Willacy, TX",37792,15,1244,53314,-15522,0.71
 2019,Williams,ND,"Williams, ND",66244,0,1194,51171,15073,1.29
 2020,Williams,ND,"Williams, ND",61077,-8,1442,61800,-723,0.99
 2021,Williams,ND,"Williams, ND",63689,4,1357,58157,5532,1.1
 2019,Williams,OH,"Williams, OH",42545,0,480,20571,21974,2.07
 2020,Williams,OH,"Williams, OH",45983,8,515,22071,23912,2.08
 2021,Williams,OH,"Williams, OH",49310,7,544,23314,25996,2.12
 2019,Williamsburg,SC,"Williamsburg, SC",33664,0,688,29486,4178,1.14
 2020,Williamsburg,SC,"Williamsburg, SC",37456,11,477,20443,17013,1.83
 2021,Williamsburg,SC,"Williamsburg, SC",40746,9,752,32229,8517,1.26
 2019,Williamson,IL,"Williamson, IL",45632,0,604,25886,19746,1.76
 2020,Williamson,IL,"Williamson, IL",48962,7,606,25971,22991,1.89
 2021,Williamson,IL,"Williamson, IL",52329,7,561,24043,28286,2.18
 2019,Williamson,TN,"Williamson, TN",95806,0,2938,125914,-30108,0.76
 2020,Williamson,TN,"Williamson, TN",99408,4,3171,135900,-36492,0.73
 2021,Williamson,TN,"Williamson, TN",107698,8,4975,213214,-105516,0.51
 2019,Williamson,TX,"Williamson, TX",54444,0,1496,64114,-9670,0.85
 2020,Williamson,TX,"Williamson, TX",57236,5,1487,63729,-6493,0.9
 2021,Williamson,TX,"Williamson, TX",62931,10,2388,102343,-39412,0.61
 2019,Wilson,KS,"Wilson, KS",41246,0,327,14014,27232,2.94
 2020,Wilson,KS,"Wilson, KS",45110,9,368,15771,29339,2.86
 2021,Wilson,KS,"Wilson, KS",47962,6,497,21300,26662,2.25
 2019,Wilson,NC,"Wilson, NC",41803,0,656,28114,13689,1.49
 2020,Wilson,NC,"Wilson, NC",44562,7,780,33429,11133,1.33
 2021,Wilson,NC,"Wilson, NC",48642,9,969,41529,7113,1.17
 2019,Wilson,TN,"Wilson, TN",52573,0,1858,79629,-27056,0.66
 2020,Wilson,TN,"Wilson, TN",54619,4,1881,80614,-25995,0.68
 2021,Wilson,TN,"Wilson, TN",59229,8,2083,89271,-30042,0.66
 2019,Wilson,TX,"Wilson, TX",50561,0,1691,72471,-21910,0.7
 2020,Wilson,TX,"Wilson, TX",52093,3,1734,74314,-22221,0.7
 2021,Wilson,TX,"Wilson, TX",55762,7,2159,92529,-36767,0.6
 2019,Windham,CT,"Windham, CT",47872,0,1193,51129,-3257,0.94
 2020,Windham,CT,"Windham, CT",51376,7,1235,52929,-1553,0.97
 2021,Windham,CT,"Windham, CT",55261,8,1432,61371,-6110,0.9
 2019,Windham,VT,"Windham, VT",49643,0,1391,59614,-9971,0.83
 2020,Windham,VT,"Windham, VT",53569,8,1436,61543,-7974,0.87
 2021,Windham,VT,"Windham, VT",55841,4,1609,68957,-13116,0.81
 2019,Windsor,VT,"Windsor, VT",61443,0,1585,67929,-6486,0.9
 2020,Windsor,VT,"Windsor, VT",65431,7,1693,72557,-7126,0.9
 2021,Windsor,VT,"Windsor, VT",69523,6,1933,82843,-13320,0.84
 2019,Winkler,TX,"Winkler, TX",66674,0,917,39300,27374,1.7
 2020,Winkler,TX,"Winkler, TX",60555,-9,929,39814,20741,1.52
 2021,Winkler,TX,"Winkler, TX",66180,9,1026,43971,22209,1.51
 2019,Winn,LA,"Winn, LA",39040,0,626,26829,12211,1.46
 2020,Winn,LA,"Winn, LA",43630,12,837,35871,7759,1.22
 2021,Winn,LA,"Winn, LA",47071,8,697,29871,17200,1.58
 2019,Winnebago,IA,"Winnebago, IA",41580,0,500,21429,20151,1.94
 2020,Winnebago,IA,"Winnebago, IA",44867,8,479,20529,24338,2.19
 2021,Winnebago,IA,"Winnebago, IA",50769,13,544,23314,27455,2.18
 2019,Winnebago,IL,"Winnebago, IL",43550,0,602,25800,17750,1.69
 2020,Winnebago,IL,"Winnebago, IL",47062,8,602,25800,21262,1.82
 2021,Winnebago,IL,"Winnebago, IL",50510,7,591,25329,25181,1.99
 2019,Winnebago,WI,"Winnebago, WI",49145,0,863,36986,12159,1.33
 2020,Winnebago,WI,"Winnebago, WI",51751,5,1147,49157,2594,1.05
 2021,Winnebago,WI,"Winnebago, WI",55202,7,1153,49414,5788,1.12
 2019,Winneshiek,IA,"Winneshiek, IA",50096,0,934,40029,10067,1.25
 2020,Winneshiek,IA,"Winneshiek, IA",54556,9,1268,54343,213,1
 2021,Winneshiek,IA,"Winneshiek, IA",58872,8,1380,59143,-271,1
 2019,Winona,MN,"Winona, MN",49315,0,819,35100,14215,1.4
 2020,Winona,MN,"Winona, MN",53431,8,957,41014,12417,1.3
 2021,Winona,MN,"Winona, MN",56240,5,1030,44143,12097,1.27
 2019,Winston,AL,"Winston, AL",35599,0,1304,55886,-20287,0.64
 2020,Winston,AL,"Winston, AL",38472,8,1625,69643,-31171,0.55
 2021,Winston,AL,"Winston, AL",41700,8,2174,93171,-51471,0.45
 2019,Winston,MS,"Winston, MS",37305,0,531,22757,14548,1.64
 2020,Winston,MS,"Winston, MS",39796,7,617,26443,13353,1.5
 2021,Winston,MS,"Winston, MS",43238,9,535,22929,20309,1.89
 2019,Wirt,WV,"Wirt, WV",35094,0,501,21471,13623,1.63
 2020,Wirt,WV,"Wirt, WV",37662,7,726,31114,6548,1.21
 2021,Wirt,WV,"Wirt, WV",40858,9,777,33300,7558,1.23
 2019,Wise,TX,"Wise, TX",47794,0,1426,61114,-13320,0.78
 2020,Wise,TX,"Wise, TX",50376,5,1543,66129,-15753,0.76
 2021,Wise,TX,"Wise, TX",53871,7,1910,81857,-27986,0.66
 2019,Wolfe,KY,"Wolfe, KY",33886,0,600,25714,8172,1.32
 2020,Wolfe,KY,"Wolfe, KY",39286,16,602,25800,13486,1.52
 2021,Wolfe,KY,"Wolfe, KY",45286,15,1325,56786,-11500,0.8
 2019,Wood,OH,"Wood, OH",48351,0,1095,46929,1422,1.03
 2020,Wood,OH,"Wood, OH",51122,6,1175,50357,765,1.02
 2021,Wood,OH,"Wood, OH",53892,5,1223,52414,1478,1.03
 2019,Wood,TX,"Wood, TX",42156,0,944,40457,1699,1.04
 2020,Wood,TX,"Wood, TX",44730,6,1163,49843,-5113,0.9
 2021,Wood,TX,"Wood, TX",47546,6,1104,47314,232,1
 2019,Wood,WI,"Wood, WI",47395,0,649,27814,19581,1.7
 2020,Wood,WI,"Wood, WI",50185,6,654,28029,22156,1.79
 2021,Wood,WI,"Wood, WI",53122,6,792,33943,19179,1.57
 2019,Wood,WV,"Wood, WV",46670,0,668,28629,18041,1.63
 2020,Wood,WV,"Wood, WV",48212,3,736,31543,16669,1.53
 2021,Wood,WV,"Wood, WV",52329,9,757,32443,19886,1.61
 2019,Woodbury,IA,"Woodbury, IA",43943,0,926,39686,4257,1.11
 2020,Woodbury,IA,"Woodbury, IA",46975,7,858,36771,10204,1.28
 2021,Woodbury,IA,"Woodbury, IA",50607,8,835,35786,14821,1.41
 2019,Woodford,IL,"Woodford, IL",52324,0,695,29786,22538,1.76
 2020,Woodford,IL,"Woodford, IL",56401,8,853,36557,19844,1.54
 2021,Woodford,IL,"Woodford, IL",60004,6,699,29957,30047,2
 2019,Woodford,KY,"Woodford, KY",53587,0,1532,65657,-12070,0.82
 2020,Woodford,KY,"Woodford, KY",56003,5,1771,75900,-19897,0.74
 2021,Woodford,KY,"Woodford, KY",59860,7,1571,67329,-7469,0.89
 2019,Woodruff,AR,"Woodruff, AR",38049,0,398,17057,20992,2.23
 2020,Woodruff,AR,"Woodruff, AR",46730,23,326,13971,32759,3.34
 2021,Woodruff,AR,"Woodruff, AR",49050,5,492,21086,27964,2.33
 2019,Woods,OK,"Woods, OK",44862,0,534,22886,21976,1.96
 2020,Woods,OK,"Woods, OK",46245,3,434,18600,27645,2.49
 2021,Woods,OK,"Woods, OK",50198,9,502,21514,28684,2.33
 2019,Woodson,KS,"Woodson, KS",38265,0,374,16029,22236,2.39
 2020,Woodson,KS,"Woodson, KS",42420,11,275,11786,30634,3.6
 2021,Woodson,KS,"Woodson, KS",47014,11,283,12129,34885,3.88
 2019,Woodward,OK,"Woodward, OK",37189,0,770,33000,4189,1.13
 2020,Woodward,OK,"Woodward, OK",39048,5,701,30043,9005,1.3
 2021,Woodward,OK,"Woodward, OK",41180,6,577,24729,16451,1.67
 2019,Worcester,MA,"Worcester, MA",56730,0,1671,71614,-14884,0.79
 2020,Worcester,MA,"Worcester, MA",61577,9,1821,78043,-16466,0.79
 2021,Worcester,MA,"Worcester, MA",65793,7,1958,83914,-18121,0.78
 2019,Worcester,MD,"Worcester, MD",57078,0,1487,63729,-6651,0.9
 2020,Worcester,MD,"Worcester, MD",60440,6,1567,67157,-6717,0.9
 2021,Worcester,MD,"Worcester, MD",63811,6,2158,92486,-28675,0.69
 2019,Worth,GA,"Worth, GA",34947,0,648,27771,7176,1.26
 2020,Worth,GA,"Worth, GA",38024,9,917,39300,-1276,0.97
 2021,Worth,GA,"Worth, GA",41431,9,835,35786,5645,1.16
 2019,Worth,IA,"Worth, IA",41759,0,559,23957,17802,1.74
 2020,Worth,IA,"Worth, IA",45956,10,610,26143,19813,1.76
 2021,Worth,IA,"Worth, IA",53342,16,502,21514,31828,2.48
 2019,Worth,MO,"Worth, MO",37715,0,460,19714,18001,1.91
 2020,Worth,MO,"Worth, MO",40892,8,288,12343,28549,3.31
 2021,Worth,MO,"Worth, MO",41952,3,679,29100,12852,1.44
 2019,Wright,IA,"Wright, IA",47573,0,513,21986,25587,2.16
 2020,Wright,IA,"Wright, IA",48666,2,578,24771,23895,1.96
 2021,Wright,IA,"Wright, IA",56543,16,665,28500,28043,1.98
 2019,Wright,MN,"Wright, MN",52363,0,1580,67714,-15351,0.77
 2020,Wright,MN,"Wright, MN",55217,6,1598,68486,-13269,0.81
 2021,Wright,MN,"Wright, MN",58756,6,1930,82714,-23958,0.71
 2019,Wright,MO,"Wright, MO",33209,0,570,24429,8780,1.36
 2020,Wright,MO,"Wright, MO",36432,10,707,30300,6132,1.2
 2021,Wright,MO,"Wright, MO",38544,6,686,29400,9144,1.31
 2019,Wyoming,NY,"Wyoming, NY",41950,0,500,21429,20521,1.96
 2020,Wyoming,NY,"Wyoming, NY",45927,10,628,26914,19013,1.71
 2021,Wyoming,NY,"Wyoming, NY",49062,7,899,38529,10533,1.27
 2019,Wyoming,PA,"Wyoming, PA",48722,0,903,38700,10022,1.26
 2020,Wyoming,PA,"Wyoming, PA",52731,8,851,36471,16260,1.45
 2021,Wyoming,PA,"Wyoming, PA",55902,6,1005,43071,12831,1.3
 2019,Wyoming,WV,"Wyoming, WV",29637,0,285,12214,17423,2.43
 2020,Wyoming,WV,"Wyoming, WV",31806,7,289,12386,19420,2.57
 2021,Wyoming,WV,"Wyoming, WV",34881,10,318,13629,21252,2.56
 2019,Wythe,VA,"Wythe, VA",36422,0,838,35914,508,1.01
 2020,Wythe,VA,"Wythe, VA",39930,10,845,36214,3716,1.1
 2021,Wythe,VA,"Wythe, VA",43593,9,1293,55414,-11821,0.79
 2019,Yadkin,NC,"Yadkin, NC",39450,0,830,35571,3879,1.11
 2020,Yadkin,NC,"Yadkin, NC",41874,6,1043,44700,-2826,0.94
 2021,Yadkin,NC,"Yadkin, NC",46172,10,1170,50143,-3971,0.92
 2019,Yakima,WA,"Yakima, WA",43208,0,1452,62229,-19021,0.69
 2020,Yakima,WA,"Yakima, WA",47315,10,1495,64071,-16756,0.74
 2021,Yakima,WA,"Yakima, WA",50872,8,1818,77914,-27042,0.65
 2019,Yalobusha,MS,"Yalobusha, MS",36651,0,466,19971,16680,1.84
 2020,Yalobusha,MS,"Yalobusha, MS",39591,8,444,19029,20562,2.08
 2021,Yalobusha,MS,"Yalobusha, MS",41761,6,866,37114,4647,1.13
 2019,Yamhill,OR,"Yamhill, OR",47337,0,2109,90386,-43049,0.52
 2020,Yamhill,OR,"Yamhill, OR",51486,9,2253,96557,-45071,0.53
 2021,Yamhill,OR,"Yamhill, OR",55802,8,2376,101829,-46027,0.55
 2019,Yancey,NC,"Yancey, NC",37365,0,1407,60300,-22935,0.62
 2020,Yancey,NC,"Yancey, NC",39832,7,1578,67629,-27797,0.59
 2021,Yancey,NC,"Yancey, NC",41892,5,2475,106071,-64179,0.39
 2019,Yankton,SD,"Yankton, SD",51256,0,920,39429,11827,1.3
 2020,Yankton,SD,"Yankton, SD",54361,6,993,42557,11804,1.28
 2021,Yankton,SD,"Yankton, SD",59224,9,1225,52500,6724,1.13
 2019,Yates,NY,"Yates, NY",42576,0,1150,49286,-6710,0.86
 2020,Yates,NY,"Yates, NY",46399,9,939,40243,6156,1.15
 2021,Yates,NY,"Yates, NY",48934,6,1460,62571,-13637,0.78
 2019,Yavapai,AZ,"Yavapai, AZ",43306,0,2042,87514,-44208,0.49
 2020,Yavapai,AZ,"Yavapai, AZ",47203,9,2229,95529,-48326,0.49
 2021,Yavapai,AZ,"Yavapai, AZ",49060,4,2703,115843,-66783,0.42
 2019,Yazoo,MS,"Yazoo, MS",28399,0,836,35829,-7430,0.79
 2020,Yazoo,MS,"Yazoo, MS",34042,20,540,23143,10899,1.47
 2021,Yazoo,MS,"Yazoo, MS",36515,7,751,32186,4329,1.13
 2019,Yell,AR,"Yell, AR",34694,0,499,21386,13308,1.62
 2020,Yell,AR,"Yell, AR",35573,3,530,22714,12859,1.57
 2021,Yell,AR,"Yell, AR",41750,17,813,34843,6907,1.2
 2019,Yellow Medicine,MN,"Yellow Medicine, MN",54679,0,500,21429,33250,2.55
 2020,Yellow Medicine,MN,"Yellow Medicine, MN",60552,11,600,25714,34838,2.35
 2021,Yellow Medicine,MN,"Yellow Medicine, MN",65068,8,576,24686,40382,2.64
 2019,Yellowstone,MT,"Yellowstone, MT",52992,0,1318,56486,-3494,0.94
 2020,Yellowstone,MT,"Yellowstone, MT",56075,6,1332,57086,-1011,0.98
 2021,Yellowstone,MT,"Yellowstone, MT",59415,6,1990,85286,-25871,0.7
 2019,Yoakum,TX,"Yoakum, TX",48623,0,802,34371,14252,1.41
 2020,Yoakum,TX,"Yoakum, TX",49127,1,756,32400,16727,1.52
 2021,Yoakum,TX,"Yoakum, TX",51954,6,992,42514,9440,1.22
 2019,Yolo,CA,"Yolo, CA",55724,0,2329,99814,-44090,0.56
 2020,Yolo,CA,"Yolo, CA",60918,9,2418,103629,-42711,0.59
 2021,Yolo,CA,"Yolo, CA",64468,6,2959,126814,-62346,0.51
 2019,York,ME,"York, ME",54335,0,1701,72900,-18565,0.75
 2020,York,ME,"York, ME",58085,7,1898,81343,-23258,0.71
 2021,York,ME,"York, ME",62355,7,2287,98014,-35659,0.64
 2019,York,NE,"York, NE",48928,0,864,37029,11899,1.32
 2020,York,NE,"York, NE",54506,11,727,31157,23349,1.75
 2021,York,NE,"York, NE",58148,7,734,31457,26691,1.85
 2019,York,PA,"York, PA",51295,0,1052,45086,6209,1.14
 2020,York,PA,"York, PA",54808,7,1191,51043,3765,1.07
 2021,York,PA,"York, PA",57870,6,1284,55029,2841,1.05
 2019,York,SC,"York, SC",50047,0,1572,67371,-17324,0.74
 2020,York,SC,"York, SC",52800,6,1672,71657,-18857,0.74
 2021,York,SC,"York, SC",56566,7,1850,79286,-22720,0.71
 2019,Young,TX,"Young, TX",52250,0,817,35014,17236,1.49
 2020,Young,TX,"Young, TX",53806,3,635,27214,26592,1.98
 2021,Young,TX,"Young, TX",58602,9,1068,45771,12831,1.28
 2019,Yuba,CA,"Yuba, CA",41443,0,1484,63600,-22157,0.65
 2020,Yuba,CA,"Yuba, CA",45806,11,1685,72214,-26408,0.63
 2021,Yuba,CA,"Yuba, CA",48984,7,2108,90343,-41359,0.54
 2019,Yukon-koyukuk,AK,"Yukon-koyukuk, AK",56750,0,524,22457,34293,2.53
 2020,Yukon-koyukuk,AK,"Yukon-koyukuk, AK",58903,4,353,15129,43774,3.89
 2021,Yukon-koyukuk,AK,"Yukon-koyukuk, AK",63452,8,1172,50229,13223,1.26
 2019,Yuma,AZ,"Yuma, AZ",37624,0,1069,45814,-8190,0.82
 2020,Yuma,AZ,"Yuma, AZ",42732,14,1094,46886,-4154,0.91
 2021,Yuma,AZ,"Yuma, AZ",44299,4,1341,57471,-13172,0.77
 2019,Yuma,CO,"Yuma, CO",44269,0,991,42471,1798,1.04
 2020,Yuma,CO,"Yuma, CO",41615,-6,1049,44957,-3342,0.93
 2021,Yuma,CO,"Yuma, CO",48898,18,1118,47914,984,1.02
 2019,Zapata,TX,"Zapata, TX",29858,0,563,24129,5729,1.24
 2020,Zapata,TX,"Zapata, TX",29865,0,608,26057,3808,1.15
 2021,Zapata,TX,"Zapata, TX",33288,12,606,25971,7317,1.28
 2019,Zavala,TX,"Zavala, TX",36521,0,411,17614,18907,2.07
 2020,Zavala,TX,"Zavala, TX",40043,10,449,19243,20800,2.08
 2021,Zavala,TX,"Zavala, TX",43868,10,501,21471,22397,2.04
 2019,Ziebach,SD,"Ziebach, SD",20352,0,0,0,20352,0
 2020,Ziebach,SD,"Ziebach, SD",27459,35,1119,47957,-20498,0.57
 2021,Ziebach,SD,"Ziebach, SD",30532,11,552,23657,6875,1.29